filename,width,height,class,xmin,ymin,xmax,ymax,,Xmax-Xmin,ymax-ymin
00000021_000.jpg,1024,1024,Small_nodule,777,716,824,769,,47,53
00000093_000.jpg,1024,1024,Large_nodule,325,249,381,317,,56,68
00000093_000.jpg,1024,1024,Large_nodule,277,314,356,391,,79,77
00000093_000.jpg,1024,1024,Large_nodule,226,509,302,584,,76,75
00000093_000.jpg,1024,1024,Large_nodule,385,605,471,680,,86,75
00000105_005.jpg,1024,1024,,207,618,256,671,,49,53
00000199_002.jpg,1024,1024,Large_nodule,592,327,666,401,,74,74
00000199_005.jpg,1024,1024,,710,356,759,408,,49,52
00000199_005.jpg,1024,1024,Large_nodule,243,236,312,306,,69,70
00000199_005.jpg,1024,1024,Large_nodule,232,389,306,456,,74,67
00000200_000.jpg,1024,1024,Large_nodule,131,623,225,743,,94,120
00000232_001.jpg,1024,1024,Large_nodule,693,499,761,571,,68,72
00000232_001.jpg,1024,1024,Large_nodule,194,610,252,688,,58,78
00000232_001.jpg,1024,1024,Large_nodule,270,620,332,707,,62,87
00000370_000.jpg,1024,1024,,741,735,792,786,,51,51
00000370_006.jpg,1024,1024,Large_nodule,753,684,828,755,,75,71
00000372_007.jpg,1024,1024,Large_nodule,595,270,665,346,,70,76
00000372_015.jpg,1024,1024,,596,159,677,218,,81,59
00000372_015.jpg,1024,1024,Large_nodule,220,201,295,264,,75,63
00000372_015.jpg,1024,1024,Large_nodule,155,268,245,335,,90,67
00000372_015.jpg,1024,1024,Large_nodule,621,266,704,330,,83,64
00000372_015.jpg,1024,1024,Large_nodule,710,305,792,376,,82,71
00000372_015.jpg,1024,1024,Large_nodule,110,409,192,483,,82,74
00000372_015.jpg,1024,1024,Large_nodule,183,488,254,558,,71,70
00000402_002.jpg,1024,1024,,340,282,389,334,,49,52
00000499_011.jpg,1024,1024,Large_nodule,259,369,362,474,,103,105
00000499_011.jpg,1024,1024,,599,406,645,461,,46,55
00000499_011.jpg,1024,1024,,649,394,700,446,,51,52
00000499_011.jpg,1024,1024,Large_nodule,299,279,366,347,,67,68
00000569_005.jpg,1024,1024,,738,684,794,726,,56,42
00000695_000.jpg,1024,1024,,770,563,824,610,,54,47
00000711_008.jpg,1024,1024,Large_nodule,568,335,645,415,,77,80
00000711_008.jpg,1024,1024,Large_nodule,654,375,732,461,,78,86
00000756_004.jpg,1024,1024,,170,409,219,462,,49,53
00000756_004.jpg,1024,1024,,839,746,890,799,,51,53
00000756_004.jpg,1024,1024,,232,352,281,403,,49,51
00000782_000.jpg,1024,1024,,872,781,919,835,,47,54
00000992_000.jpg,1024,1024,,790,633,842,684,,52,51
00000992_000.jpg,1024,1024,,831,701,884,746,,53,45
00001023_001.jpg,1024,1024,,820,719,871,767,,51,48
00001023_001.jpg,1024,1024,Large_nodule,709,587,791,648,,82,61
00001182_005.jpg,1024,1024,Large_nodule,650,458,760,591,,110,133
00001182_005.jpg,1024,1024,Large_nodule,736,658,835,770,,99,112
00001285_000.jpg,1024,1024,Large_nodule,735,406,810,488,,75,82
00001285_000.jpg,1024,1024,Large_nodule,774,506,838,592,,64,86
00001286_000.jpg,1024,1024,,763,265,807,298,,44,33
00001286_002.jpg,1024,1024,,597,270,649,317,,52,47
00001286_002.jpg,1024,1024,Large_nodule,643,611,708,702,,65,91
00001320_002.jpg,1024,1024,Large_nodule,624,379,693,448,,69,69
00001320_002.jpg,1024,1024,Large_nodule,706,677,794,748,,88,71
00001333_000.jpg,1024,1024,,677,263,726,315,,49,52
00001442_000.jpg,1024,1024,,283,379,330,432,,47,53
00001442_000.jpg,1024,1024,,185,726,233,779,,48,53
00001456_000.jpg,1024,1024,,790,475,838,527,,48,52
00001465_000.jpg,1024,1024,,193,404,243,455,,50,51
00001555_002.jpg,1024,1024,,222,659,253,698,,31,39
00001555_002.jpg,1024,1024,,633,835,665,875,,32,40
00001673_001.jpg,1024,1024,,780,619,815,657,,35,38
00001722_001.jpg,1024,1024,Large_nodule,707,538,776,618,,69,80
00001772_001.jpg,1024,1024,Large_nodule,344,328,422,407,,78,79
00001772_001.jpg,1024,1024,Large_nodule,770,588,852,659,,82,71
00001781_001.jpg,1024,1024,,238,358,284,390,,46,32
00001781_001.jpg,1024,1024,,323,170,380,213,,57,43
00001781_002.jpg,1024,1024,,236,425,292,468,,56,43
00002010_001.jpg,1024,1024,,825,618,880,667,,55,49
00002264_000.jpg,1024,1024,,185,595,235,647,,50,52
00002271_004.jpg,1024,1024,,311,565,364,615,,53,50
00002361_008.jpg,1024,1024,Large_nodule,528,586,650,755,,122,169
00002361_008.jpg,1024,1024,Large_nodule,114,597,265,788,,151,191
00002361_008.jpg,1024,1024,Large_nodule,180,629,356,807,,176,178
00002361_008.jpg,1024,1024,,295,315,350,364,,55,49
00002361_008.jpg,1024,1024,Large_nodule,709,572,778,648,,69,76
00002424_001.jpg,1024,1024,Large_nodule,322,192,408,256,,86,64
00002437_011.jpg,1024,1024,Large_nodule,664,286,779,408,,115,122
00002437_011.jpg,1024,1024,Large_nodule,206,457,325,588,,119,131
00002437_011.jpg,1024,1024,Large_nodule,255,245,326,316,,71,71
00002437_011.jpg,1024,1024,Large_nodule,240,353,317,429,,77,76
00002437_011.jpg,1024,1024,Large_nodule,725,389,800,464,,75,75
00002544_003.jpg,1024,1024,,165,514,219,561,,54,47
00002547_004.jpg,1024,1024,,98,444,137,479,,39,35
00002599_003.jpg,1024,1024,Large_nodule,724,478,787,566,,63,88
00002599_003.jpg,1024,1024,Large_nodule,750,559,816,638,,66,79
00002599_003.jpg,1024,1024,Large_nodule,771,648,850,720,,79,72
00002763_032.jpg,1024,1024,Large_nodule,331,180,421,304,,90,124
00002763_032.jpg,1024,1024,,221,369,277,415,,56,46
00002763_035.jpg,1024,1024,Large_nodule,196,351,272,419,,76,68
00002785_001.jpg,1024,1024,Large_nodule,342,198,413,269,,71,71
00002785_001.jpg,1024,1024,Large_nodule,713,472,779,551,,66,79
00002785_001.jpg,1024,1024,Large_nodule,143,621,212,704,,69,83
00002868_000.jpg,1024,1024,Large_nodule,316,487,412,610,,96,123
00002868_000.jpg,1024,1024,Large_nodule,237,647,356,774,,119,127
00002868_000.jpg,1024,1024,Large_nodule,112,815,156,874,,44,59
00002868_000.jpg,1024,1024,Large_nodule,310,392,380,485,,70,93
00002868_000.jpg,1024,1024,Large_nodule,324,585,394,662,,70,77
00003285_000.jpg,1024,1024,Large_nodule,648,738,782,888,,134,150
00003285_000.jpg,1024,1024,,871,569,907,607,,36,38
00003285_000.jpg,1024,1024,,639,167,686,219,,47,52
00003285_000.jpg,1024,1024,,143,811,192,867,,49,56
00003285_000.jpg,1024,1024,Large_nodule,710,346,779,422,,69,76
00003285_000.jpg,1024,1024,Large_nodule,307,598,377,669,,70,71
00003285_000.jpg,1024,1024,Large_nodule,189,778,255,857,,66,79
00003285_000.jpg,1024,1024,Large_nodule,113,936,184,1010,,71,74
00003300_001.jpg,1024,1024,Large_nodule,652,738,792,921,,140,183
00003300_001.jpg,1024,1024,Large_nodule,675,461,745,540,,70,79
00003300_006.jpg,1024,1024,Large_nodule,174,400,275,518,,101,118
00003300_006.jpg,1024,1024,Large_nodule,659,635,854,872,,195,237
00003300_006.jpg,1024,1024,,681,317,733,368,,52,51
00003300_006.jpg,1024,1024,,159,493,209,543,,50,50
00003369_016.jpg,1024,1024,Large_nodule,693,447,808,568,,115,121
00003369_016.jpg,1024,1024,Large_nodule,779,491,889,621,,110,130
00003369_016.jpg,1024,1024,Large_nodule,264,525,372,641,,108,116
00003369_016.jpg,1024,1024,Large_nodule,615,165,691,237,,76,72
00003369_016.jpg,1024,1024,Large_nodule,727,596,814,681,,87,85
00003369_016.jpg,1024,1024,Large_nodule,667,679,752,757,,85,78
00003369_016.jpg,1024,1024,Large_nodule,820,691,894,773,,74,82
00003423_006.jpg,1024,1024,,338,641,385,697,,47,56
00003423_006.jpg,1024,1024,Large_nodule,722,426,790,508,,68,82
00003519_000.jpg,1024,1024,Large_nodule,198,255,313,359,,115,104
00003519_000.jpg,1024,1024,Large_nodule,274,563,433,712,,159,149
00003519_000.jpg,1024,1024,Large_nodule,567,615,723,741,,156,126
00003519_000.jpg,1024,1024,Large_nodule,774,615,877,725,,103,110
00003519_000.jpg,1024,1024,,703,296,760,337,,57,41
00003519_000.jpg,1024,1024,,770,334,824,383,,54,49
00003519_000.jpg,1024,1024,,727,365,780,410,,53,45
00003519_000.jpg,1024,1024,,214,472,270,519,,56,47
00003519_000.jpg,1024,1024,,754,478,810,525,,56,47
00003519_000.jpg,1024,1024,,211,534,267,582,,56,48
00003519_000.jpg,1024,1024,,841,572,895,620,,54,48
00003519_000.jpg,1024,1024,Large_nodule,222,232,302,295,,80,63
00003519_000.jpg,1024,1024,Large_nodule,589,222,667,288,,78,66
00003519_000.jpg,1024,1024,Large_nodule,765,253,843,316,,78,63
00003519_000.jpg,1024,1024,Large_nodule,708,318,779,387,,71,69
00003519_000.jpg,1024,1024,Large_nodule,224,359,302,436,,78,77
00003519_000.jpg,1024,1024,Large_nodule,803,405,876,472,,73,67
00003519_000.jpg,1024,1024,Large_nodule,134,627,211,697,,77,70
00003547_000.jpg,1024,1024,Large_nodule,714,562,803,639,,89,77
00003547_000.jpg,1024,1024,Large_nodule,589,661,690,784,,101,123
00003547_000.jpg,1024,1024,,162,723,195,761,,33,38
00003547_000.jpg,1024,1024,,357,251,405,304,,48,53
00003547_000.jpg,1024,1024,,287,462,337,517,,50,55
00003547_000.jpg,1024,1024,,786,443,843,491,,57,48
00003547_000.jpg,1024,1024,,255,521,307,572,,52,51
00003547_000.jpg,1024,1024,,830,641,879,697,,49,56
00003547_000.jpg,1024,1024,Large_nodule,713,216,779,292,,66,76
00003547_000.jpg,1024,1024,Large_nodule,273,293,340,369,,67,76
00003547_000.jpg,1024,1024,Large_nodule,387,313,459,387,,72,74
00003547_000.jpg,1024,1024,Large_nodule,303,371,371,441,,68,70
00003547_000.jpg,1024,1024,Large_nodule,673,345,747,430,,74,85
00003547_000.jpg,1024,1024,Large_nodule,216,388,288,454,,72,66
00003547_000.jpg,1024,1024,Large_nodule,755,383,826,463,,71,80
00003547_000.jpg,1024,1024,Large_nodule,319,432,388,505,,69,73
00003547_000.jpg,1024,1024,Large_nodule,707,436,778,513,,71,77
00003547_000.jpg,1024,1024,Large_nodule,762,483,838,557,,76,74
00003547_000.jpg,1024,1024,Large_nodule,269,528,335,599,,66,71
00003547_000.jpg,1024,1024,Large_nodule,645,528,705,603,,60,75
00003547_000.jpg,1024,1024,Large_nodule,760,542,831,615,,71,73
00003547_000.jpg,1024,1024,Large_nodule,263,640,336,716,,73,76
00003547_000.jpg,1024,1024,Large_nodule,352,622,421,709,,69,87
00003547_000.jpg,1024,1024,Large_nodule,601,633,666,709,,65,76
00003547_001.jpg,1024,1024,Large_nodule,332,421,437,537,,105,116
00003547_001.jpg,1024,1024,Large_nodule,216,655,329,762,,113,107
00003547_001.jpg,1024,1024,Large_nodule,331,641,423,767,,92,126
00003547_001.jpg,1024,1024,Large_nodule,571,696,685,810,,114,114
00003547_001.jpg,1024,1024,,373,243,420,298,,47,55
00003547_001.jpg,1024,1024,,337,322,385,377,,48,55
00003547_001.jpg,1024,1024,,781,447,830,500,,49,53
00003547_001.jpg,1024,1024,,279,476,334,528,,55,52
00003547_001.jpg,1024,1024,,247,536,297,585,,50,49
00003547_001.jpg,1024,1024,,826,660,874,718,,48,58
00003547_001.jpg,1024,1024,Large_nodule,603,197,671,274,,68,77
00003547_001.jpg,1024,1024,Large_nodule,709,233,775,309,,66,76
00003547_001.jpg,1024,1024,Large_nodule,271,291,336,359,,65,68
00003547_001.jpg,1024,1024,Large_nodule,329,271,389,343,,60,72
00003547_001.jpg,1024,1024,Large_nodule,666,356,741,434,,75,78
00003547_001.jpg,1024,1024,Large_nodule,205,384,275,455,,70,71
00003547_001.jpg,1024,1024,Large_nodule,274,379,339,446,,65,67
00003547_001.jpg,1024,1024,Large_nodule,752,393,815,469,,63,76
00003547_001.jpg,1024,1024,Large_nodule,322,432,392,507,,70,75
00003547_001.jpg,1024,1024,Large_nodule,696,459,760,535,,64,76
00003547_001.jpg,1024,1024,Large_nodule,351,525,419,602,,68,77
00003547_001.jpg,1024,1024,Large_nodule,753,509,825,599,,72,90
00003547_001.jpg,1024,1024,Large_nodule,748,546,824,631,,76,85
00003547_001.jpg,1024,1024,Large_nodule,595,648,665,723,,70,75
00003547_001.jpg,1024,1024,Large_nodule,695,632,762,708,,67,76
00003547_001.jpg,1024,1024,Large_nodule,714,647,774,724,,60,77
00003547_003.jpg,1024,1024,Large_nodule,514,236,613,355,,99,119
00003547_003.jpg,1024,1024,Large_nodule,623,256,716,384,,93,128
00003547_003.jpg,1024,1024,Large_nodule,541,368,674,512,,133,144
00003547_003.jpg,1024,1024,Large_nodule,289,396,392,519,,103,123
00003547_003.jpg,1024,1024,Large_nodule,124,466,225,581,,101,115
00003547_003.jpg,1024,1024,Large_nodule,683,518,808,684,,125,166
00003547_003.jpg,1024,1024,Large_nodule,577,652,695,790,,118,138
00003547_003.jpg,1024,1024,Large_nodule,272,295,345,390,,73,95
00003547_003.jpg,1024,1024,Large_nodule,203,397,280,481,,77,84
00003547_003.jpg,1024,1024,Large_nodule,672,443,749,513,,77,70
00003547_003.jpg,1024,1024,Large_nodule,655,465,723,545,,68,80
00003547_003.jpg,1024,1024,Large_nodule,226,520,304,604,,78,84
00003547_003.jpg,1024,1024,Large_nodule,627,512,698,594,,71,82
00003547_003.jpg,1024,1024,Large_nodule,176,567,246,654,,70,87
00003547_003.jpg,1024,1024,Large_nodule,126,635,198,710,,72,75
00003547_003.jpg,1024,1024,Large_nodule,192,669,271,748,,79,79
00003547_003.jpg,1024,1024,Large_nodule,590,718,664,790,,74,72
00003547_003.jpg,1024,1024,Large_nodule,764,700,831,782,,67,82
00003654_000.jpg,1024,1024,,740,515,775,556,,35,41
00003654_000.jpg,1024,1024,,346,571,381,608,,35,37
00003733_006.jpg,1024,1024,Large_nodule,709,280,781,364,,72,84
00003751_003.jpg,1024,1024,Large_nodule,189,524,312,638,,123,114
00003751_003.jpg,1024,1024,Large_nodule,761,442,832,512,,71,70
00003751_003.jpg,1024,1024,Large_nodule,797,526,874,600,,77,74
00003759_000.jpg,1024,1024,Large_nodule,246,442,364,558,,118,116
00003759_000.jpg,1024,1024,Large_nodule,354,483,447,604,,93,121
00003759_000.jpg,1024,1024,Large_nodule,191,403,271,483,,80,80
00003759_000.jpg,1024,1024,Large_nodule,245,603,309,681,,64,78
00003846_000.jpg,1024,1024,Large_nodule,559,329,685,430,,126,101
00003846_000.jpg,1024,1024,Large_nodule,109,446,256,574,,147,128
00003846_000.jpg,1024,1024,,161,284,218,325,,57,41
00003846_000.jpg,1024,1024,,206,297,268,341,,62,44
00003846_000.jpg,1024,1024,,154,360,214,406,,60,46
00003846_000.jpg,1024,1024,,115,574,172,619,,57,45
00003846_000.jpg,1024,1024,,741,656,791,707,,50,51
00003846_000.jpg,1024,1024,,787,654,840,701,,53,47
00003846_000.jpg,1024,1024,Large_nodule,702,204,793,266,,91,62
00003846_000.jpg,1024,1024,Large_nodule,707,225,800,288,,93,63
00003846_000.jpg,1024,1024,,671,310,762,368,,91,58
00003846_000.jpg,1024,1024,Large_nodule,170,345,249,408,,79,63
00003846_000.jpg,1024,1024,Large_nodule,601,406,681,468,,80,62
00003846_000.jpg,1024,1024,Large_nodule,129,437,216,503,,87,66
00003846_000.jpg,1024,1024,Large_nodule,728,437,812,504,,84,67
00003846_000.jpg,1024,1024,Large_nodule,797,496,878,559,,81,63
00003846_000.jpg,1024,1024,Large_nodule,666,524,740,585,,74,61
00003846_000.jpg,1024,1024,Large_nodule,830,572,915,635,,85,63
00003846_000.jpg,1024,1024,Large_nodule,155,598,235,661,,80,63
00003846_000.jpg,1024,1024,Large_nodule,595,642,672,706,,77,64
00003846_000.jpg,1024,1024,Large_nodule,666,647,735,713,,69,66
00003846_000.jpg,1024,1024,Large_nodule,842,637,917,702,,75,65
00003846_000.jpg,1024,1024,Large_nodule,697,705,773,773,,76,68
00003846_000.jpg,1024,1024,Large_nodule,703,359,795,433,,92,74
00003973_014.jpg,1024,1024,Large_nodule,750,466,816,542,,66,76
00004001_012.jpg,1024,1024,,792,306,839,361,,47,55
00004049_000.jpg,1024,1024,Large_nodule,717,537,793,606,,76,69
00004214_000.jpg,1024,1024,Large_nodule,683,127,805,218,,122,91
00004214_000.jpg,1024,1024,Large_nodule,809,383,919,477,,110,94
00004214_000.jpg,1024,1024,Large_nodule,656,459,787,572,,131,113
00004214_000.jpg,1024,1024,Large_nodule,828,618,934,744,,106,126
00004214_000.jpg,1024,1024,,142,266,195,316,,53,50
00004214_000.jpg,1024,1024,,701,448,756,495,,55,47
00004214_000.jpg,1024,1024,Large_nodule,358,201,438,266,,80,65
00004214_000.jpg,1024,1024,Large_nodule,407,247,486,320,,79,73
00004214_000.jpg,1024,1024,Large_nodule,722,239,802,306,,80,67
00004214_000.jpg,1024,1024,Large_nodule,783,273,865,339,,82,66
00004214_000.jpg,1024,1024,Large_nodule,109,415,187,481,,78,66
00004214_000.jpg,1024,1024,,149,473,227,532,,78,59
00004214_000.jpg,1024,1024,Large_nodule,756,640,843,709,,87,69
00004224_001.jpg,1024,1024,Large_nodule,317,377,460,481,,143,104
00004224_001.jpg,1024,1024,Large_nodule,204,530,356,640,,152,110
00004224_001.jpg,1024,1024,Large_nodule,658,593,784,697,,126,104
00004224_001.jpg,1024,1024,,813,278,874,321,,61,43
00004224_001.jpg,1024,1024,,184,411,243,456,,59,45
00004224_001.jpg,1024,1024,,196,450,255,496,,59,46
00004224_001.jpg,1024,1024,,877,560,933,608,,56,48
00004224_001.jpg,1024,1024,Large_nodule,313,190,396,251,,83,61
00004224_001.jpg,1024,1024,Large_nodule,772,318,857,384,,85,66
00004224_001.jpg,1024,1024,Large_nodule,188,348,279,416,,91,68
00004224_001.jpg,1024,1024,Large_nodule,308,373,388,438,,80,65
00004224_001.jpg,1024,1024,Large_nodule,769,364,853,433,,84,69
00004224_001.jpg,1024,1024,,786,387,869,447,,83,60
00004224_001.jpg,1024,1024,,254,433,334,493,,80,60
00004224_001.jpg,1024,1024,Large_nodule,139,482,212,547,,73,65
00004224_001.jpg,1024,1024,Large_nodule,819,474,896,543,,77,69
00004224_001.jpg,1024,1024,Large_nodule,813,569,889,635,,76,66
00004224_001.jpg,1024,1024,Large_nodule,837,562,918,629,,81,67
00004396_001.jpg,1024,1024,Large_nodule,654,285,753,413,,99,128
00004396_001.jpg,1024,1024,Large_nodule,715,509,819,626,,104,117
00004396_001.jpg,1024,1024,Large_nodule,574,727,707,874,,133,147
00004396_001.jpg,1024,1024,Large_nodule,695,862,836,981,,141,119
00004396_001.jpg,1024,1024,Large_nodule,635,634,706,715,,71,81
00004396_001.jpg,1024,1024,Large_nodule,776,771,843,861,,67,90
00004399_000.jpg,1024,1024,Large_nodule,195,286,369,539,,174,253
00004399_000.jpg,1024,1024,Large_nodule,659,610,794,763,,135,153
00004399_000.jpg,1024,1024,Large_nodule,759,387,840,456,,81,69
00004399_000.jpg,1024,1024,Large_nodule,654,385,723,472,,69,87
00004436_000.jpg,1024,1024,Large_nodule,620,530,750,640,,130,110
00004494_000.jpg,1024,1024,Large_nodule,912,569,965,618,,53,49
00004519_003.jpg,1024,1024,Large_nodule,297,497,400,609,,103,112
00004519_003.jpg,1024,1024,Large_nodule,735,563,845,695,,110,132
00004519_003.jpg,1024,1024,Large_nodule,202,624,316,736,,114,112
00004519_003.jpg,1024,1024,,786,386,833,443,,47,57
00004519_003.jpg,1024,1024,,208,478,257,532,,49,54
00004519_003.jpg,1024,1024,Large_nodule,241,226,310,299,,69,73
00004519_003.jpg,1024,1024,Large_nodule,670,283,738,365,,68,82
00004519_003.jpg,1024,1024,Large_nodule,280,456,348,539,,68,83
00004519_003.jpg,1024,1024,Large_nodule,756,554,831,629,,75,75
00004519_003.jpg,1024,1024,Large_nodule,649,603,721,677,,72,74
00004519_003.jpg,1024,1024,Large_nodule,747,652,828,721,,81,69
00004519_003.jpg,1024,1024,Large_nodule,689,679,767,749,,78,70
00004519_003.jpg,1024,1024,Large_nodule,853,675,918,749,,65,74
00004519_003.jpg,1024,1024,Large_nodule,808,708,880,786,,72,78
00004520_000.jpg,1024,1024,Large_nodule,253,262,364,361,,111,99
00004520_000.jpg,1024,1024,Large_nodule,280,369,457,512,,177,143
00004520_000.jpg,1024,1024,,798,410,860,455,,62,45
00004520_000.jpg,1024,1024,Large_nodule,745,316,820,379,,75,63
00004520_000.jpg,1024,1024,Large_nodule,831,303,907,368,,76,65
00004520_000.jpg,1024,1024,Large_nodule,790,362,867,425,,77,63
00004545_000.jpg,1024,1024,Large_nodule,750,407,846,530,,96,123
00004545_000.jpg,1024,1024,Large_nodule,728,580,891,796,,163,216
00004545_000.jpg,1024,1024,Large_nodule,919,639,984,717,,65,78
00004545_000.jpg,1024,1024,Large_nodule,854,793,927,864,,73,71
00004545_000.jpg,1024,1024,,925,786,974,837,,49,51
00004547_018.jpg,1024,1024,Large_nodule,253,505,329,584,,76,79
00004547_018.jpg,1024,1024,Large_nodule,389,572,457,647,,68,75
00004547_018.jpg,1024,1024,Large_nodule,928,637,997,716,,69,79
00004652_008.jpg,1024,1024,Large_nodule,837,512,909,605,,72,93
00004738_001.jpg,1024,1024,Large_nodule,741,343,824,405,,83,62
00004738_001.jpg,1024,1024,Large_nodule,766,427,840,503,,74,76
00004806_000.jpg,1024,1024,Large_nodule,310,147,395,207,,85,60
00004806_000.jpg,1024,1024,Large_nodule,174,359,257,420,,83,61
00004806_000.jpg,1024,1024,Large_nodule,723,397,805,476,,82,79
00004806_000.jpg,1024,1024,Large_nodule,108,462,187,525,,79,63
00004806_000.jpg,1024,1024,Large_nodule,804,497,881,561,,77,64
00004806_000.jpg,1024,1024,Large_nodule,815,655,897,716,,82,61
00004911_015.jpg,1024,1024,Large_nodule,710,366,787,444,,77,78
00004911_016.jpg,1024,1024,Large_nodule,709,364,814,471,,105,107
00004911_023.jpg,1024,1024,Large_nodule,640,306,744,425,,104,119
00004928_003.jpg,1024,1024,Large_nodule,793,267,913,366,,120,99
00004928_003.jpg,1024,1024,Large_nodule,148,386,305,494,,157,108
00004928_003.jpg,1024,1024,Large_nodule,310,459,446,581,,136,122
00004928_003.jpg,1024,1024,Large_nodule,625,434,757,566,,132,132
00004928_003.jpg,1024,1024,Large_nodule,604,582,738,695,,134,113
00004928_003.jpg,1024,1024,Large_nodule,209,179,305,245,,96,66
00004928_003.jpg,1024,1024,Large_nodule,689,178,766,240,,77,62
00004928_003.jpg,1024,1024,Large_nodule,165,222,250,285,,85,63
00004928_003.jpg,1024,1024,Large_nodule,257,274,344,337,,87,63
00004928_003.jpg,1024,1024,Large_nodule,757,351,846,416,,89,65
00004928_003.jpg,1024,1024,,107,432,194,492,,87,60
00004928_003.jpg,1024,1024,Large_nodule,758,489,832,553,,74,64
00004928_003.jpg,1024,1024,Large_nodule,814,490,894,552,,80,62
00004928_003.jpg,1024,1024,Large_nodule,710,568,810,640,,100,72
00004928_003.jpg,1024,1024,Large_nodule,790,549,875,618,,85,69
00004928_003.jpg,1024,1024,Large_nodule,728,682,821,746,,93,64
00004943_002.jpg,1024,1024,Large_nodule,365,241,480,404,,115,163
00004943_002.jpg,1024,1024,Large_nodule,260,499,354,596,,94,97
00004943_002.jpg,1024,1024,Large_nodule,269,548,427,723,,158,175
00004943_002.jpg,1024,1024,Large_nodule,797,576,916,720,,119,144
00004943_002.jpg,1024,1024,Large_nodule,705,758,806,869,,101,111
00004943_002.jpg,1024,1024,Large_nodule,664,139,743,213,,79,74
00004943_002.jpg,1024,1024,Large_nodule,212,378,285,453,,73,75
00004943_002.jpg,1024,1024,Large_nodule,189,447,257,522,,68,75
00004943_002.jpg,1024,1024,Large_nodule,845,770,914,850,,69,80
00004957_000.jpg,1024,1024,Large_nodule,759,269,865,404,,106,135
00004957_000.jpg,1024,1024,Large_nodule,367,386,496,551,,129,165
00004957_000.jpg,1024,1024,Large_nodule,274,453,342,525,,68,72
00004957_000.jpg,1024,1024,Large_nodule,769,690,843,759,,74,69
00004957_003.jpg,1024,1024,Large_nodule,695,358,802,475,,107,117
00004957_003.jpg,1024,1024,Large_nodule,547,641,661,793,,114,152
00004957_003.jpg,1024,1024,nodule,285,404,333,458,,48,54
00004957_003.jpg,1024,1024,nodule,829,659,876,718,,47,59
00004957_003.jpg,1024,1024,nodule,216,500,283,572,,67,72
00005014_007.jpg,1024,1024,nodule,206,256,272,345,,66,89
00005014_007.jpg,1024,1024,nodule,793,633,860,712,,67,79
00005014_007.jpg,1024,1024,nodule,184,793,264,869,,80,76
00005024_000.jpg,1024,1024,nodule,158,531,208,583,,50,52
00005024_000.jpg,1024,1024,nodule,124,706,173,758,,49,52
00005024_000.jpg,1024,1024,nodule,645,741,724,821,,79,80
00005053_000.jpg,1024,1024,nodule,198,452,259,494,,61,42
00005053_000.jpg,1024,1024,nodule,66,581,125,623,,59,42
00005103_000.jpg,1024,1024,nodule,736,259,778,320,,42,61
00005103_000.jpg,1024,1024,nodule,294,616,343,671,,49,55
00005103_000.jpg,1024,1024,nodule,364,496,428,579,,64,83
00005109_000.jpg,1024,1024,nodule,184,394,222,432,,38,38
00005109_000.jpg,1024,1024,nodule,157,505,201,545,,44,40
00005109_000.jpg,1024,1024,nodule,237,267,272,292,,35,25
00005109_000.jpg,1024,1024,nodule,453,386,525,458,,72,72
00005109_000.jpg,1024,1024,nodule,213,468,294,532,,81,64
00005109_000.jpg,1024,1024,nodule,386,462,463,531,,77,69
00005110_002.jpg,1024,1024,nodule,295,430,347,482,,52,52
00005115_001.jpg,1024,1024,nodule,216,453,294,523,,78,70
00005153_000.jpg,1024,1024,nodule,324,226,441,336,,117,110
00005153_000.jpg,1024,1024,nodule,810,222,851,257,,41,35
00005153_000.jpg,1024,1024,nodule,735,348,778,382,,43,34
00005153_000.jpg,1024,1024,nodule,698,146,757,189,,59,43
00005153_000.jpg,1024,1024,nodule,284,209,346,251,,62,42
00005153_000.jpg,1024,1024,nodule,718,210,772,255,,54,45
00005153_000.jpg,1024,1024,nodule,208,254,262,298,,54,44
00005153_000.jpg,1024,1024,nodule,787,371,846,412,,59,41
00005153_000.jpg,1024,1024,nodule,169,404,223,449,,54,45
00005153_000.jpg,1024,1024,nodule,699,402,760,448,,61,46
00005153_000.jpg,1024,1024,nodule,169,442,229,484,,60,42
00005153_000.jpg,1024,1024,nodule,689,466,748,510,,59,44
00005153_000.jpg,1024,1024,nodule,814,507,870,550,,56,43
00005153_000.jpg,1024,1024,nodule,857,523,918,566,,61,43
00005153_000.jpg,1024,1024,nodule,636,201,708,266,,72,65
00005153_000.jpg,1024,1024,nodule,248,287,335,354,,87,67
00005153_000.jpg,1024,1024,nodule,310,352,384,414,,74,62
00005153_000.jpg,1024,1024,nodule,231,403,325,475,,94,72
00005153_000.jpg,1024,1024,nodule,178,476,270,539,,92,63
00005153_000.jpg,1024,1024,nodule,312,467,393,536,,81,69
00005153_000.jpg,1024,1024,nodule,603,559,680,624,,77,65
00005153_000.jpg,1024,1024,nodule,670,581,755,638,,85,57
00005153_000.jpg,1024,1024,nodule,238,339,342,387,,104,48
00005218_012.jpg,1024,1024,nodule,252,687,366,797,,114,110
00005218_026.jpg,1024,1024,nodule,210,570,324,674,,114,104
00005218_026.jpg,1024,1024,nodule,713,779,829,913,,116,134
00005218_026.jpg,1024,1024,nodule,327,420,381,469,,54,49
00005218_026.jpg,1024,1024,nodule,733,581,806,667,,73,86
00005218_026.jpg,1024,1024,nodule,643,714,710,789,,67,75
00005218_026.jpg,1024,1024,nodule,728,721,795,805,,67,84
00005218_026.jpg,1024,1024,nodule,774,707,837,784,,63,77
00005221_001.jpg,1024,1024,nodule,700,279,832,410,,132,131
00005221_001.jpg,1024,1024,nodule,212,396,344,560,,132,164
00005221_001.jpg,1024,1024,nodule,759,427,867,546,,108,119
00005221_001.jpg,1024,1024,nodule,287,558,421,716,,134,158
00005221_001.jpg,1024,1024,nodule,114,614,201,737,,87,123
00005221_001.jpg,1024,1024,nodule,167,672,264,789,,97,117
00005221_001.jpg,1024,1024,nodule,855,753,928,841,,73,88
00005487_000.jpg,1024,1024,nodule,205,713,253,767,,48,54
00005609_029.jpg,1024,1024,nodule,680,263,726,318,,46,55
00005609_029.jpg,1024,1024,nodule,691,356,741,411,,50,55
00005609_029.jpg,1024,1024,nodule,712,412,759,464,,47,52
00005609_029.jpg,1024,1024,nodule,777,609,850,679,,73,70
00005609_029.jpg,1024,1024,nodule,558,669,629,746,,71,77
00005624_002.jpg,1024,1024,nodule,146,686,236,823,,90,137
00005624_002.jpg,1024,1024,nodule,284,508,317,550,,33,42
00005624_002.jpg,1024,1024,nodule,243,336,294,384,,51,48
00005624_002.jpg,1024,1024,nodule,313,380,361,434,,48,54
00005624_002.jpg,1024,1024,nodule,243,433,291,484,,48,51
00005624_002.jpg,1024,1024,nodule,252,575,300,631,,48,56
00005624_002.jpg,1024,1024,nodule,132,625,179,681,,47,56
00005664_000.jpg,1024,1024,nodule,238,448,282,506,,44,58
00005664_000.jpg,1024,1024,nodule,709,592,780,673,,71,81
00005664_000.jpg,1024,1024,nodule,108,703,173,780,,65,77
00005664_000.jpg,1024,1024,nodule,319,843,386,920,,67,77
00005666_003.jpg,1024,1024,nodule,750,383,822,454,,72,71
00005694_003.jpg,1024,1024,nodule,132,696,252,827,,120,131
00005694_003.jpg,1024,1024,nodule,205,573,255,626,,50,53
00005694_003.jpg,1024,1024,nodule,276,277,343,354,,67,77
00005694_003.jpg,1024,1024,nodule,764,612,839,692,,75,80
00005694_003.jpg,1024,1024,nodule,216,661,292,739,,76,78
00005799_000.jpg,1024,1024,nodule,184,435,219,460,,35,25
00005799_000.jpg,1024,1024,nodule,262,608,307,643,,45,35
00005862_001.jpg,1024,1024,nodule,267,635,315,690,,48,55
00005935_003.jpg,1024,1024,nodule,726,709,778,757,,52,48
00005935_003.jpg,1024,1024,nodule,530,470,611,550,,81,80
00005940_001.jpg,1024,1024,nodule,369,300,419,349,,50,49
00006096_003.jpg,1024,1024,nodule,887,726,939,776,,52,50
00006096_003.jpg,1024,1024,nodule,686,276,764,351,,78,75
00006096_003.jpg,1024,1024,nodule,217,427,291,501,,74,74
00006096_003.jpg,1024,1024,nodule,797,536,872,603,,75,67
00006096_003.jpg,1024,1024,nodule,342,549,417,633,,75,84
00006096_003.jpg,1024,1024,nodule,238,583,324,672,,86,89
00006096_003.jpg,1024,1024,nodule,759,592,834,661,,75,69
00006096_003.jpg,1024,1024,nodule,157,641,245,715,,88,74
00006096_003.jpg,1024,1024,nodule,222,672,301,737,,79,65
00006096_003.jpg,1024,1024,nodule,197,751,274,818,,77,67
00006096_003.jpg,1024,1024,nodule,786,773,869,837,,83,64
00006096_007.jpg,1024,1024,nodule,598,259,695,369,,97,110
00006096_007.jpg,1024,1024,nodule,191,598,314,727,,123,129
00006096_007.jpg,1024,1024,nodule,119,651,237,766,,118,115
00006096_007.jpg,1024,1024,nodule,626,349,699,416,,73,67
00006096_007.jpg,1024,1024,nodule,149,409,227,477,,78,68
00006096_007.jpg,1024,1024,nodule,145,477,228,556,,83,79
00006096_007.jpg,1024,1024,nodule,716,573,788,648,,72,75
00006096_007.jpg,1024,1024,nodule,725,636,802,720,,77,84
00006096_007.jpg,1024,1024,nodule,309,667,391,741,,82,74
00006252_001.jpg,1024,1024,nodule,704,182,803,298,,99,116
00006252_001.jpg,1024,1024,nodule,171,235,284,404,,113,169
00006252_001.jpg,1024,1024,nodule,815,408,864,460,,49,52
00006252_001.jpg,1024,1024,nodule,800,617,848,670,,48,53
00006252_001.jpg,1024,1024,nodule,663,278,740,370,,77,92
00006252_001.jpg,1024,1024,nodule,751,275,836,356,,85,81
00006252_001.jpg,1024,1024,nodule,288,431,350,510,,62,79
00006252_001.jpg,1024,1024,nodule,262,528,332,612,,70,84
00006273_002.jpg,1024,1024,nodule,581,369,670,506,,89,137
00006273_002.jpg,1024,1024,nodule,642,401,773,559,,131,158
00006273_002.jpg,1024,1024,nodule,297,471,414,647,,117,176
00006273_002.jpg,1024,1024,nodule,657,576,745,685,,88,109
00006273_002.jpg,1024,1024,nodule,277,662,405,779,,128,117
00006273_002.jpg,1024,1024,nodule,578,151,631,199,,53,48
00006273_002.jpg,1024,1024,nodule,206,252,278,330,,72,78
00006273_002.jpg,1024,1024,nodule,138,489,205,558,,67,69
00006273_002.jpg,1024,1024,nodule,168,542,248,612,,80,70
00006273_002.jpg,1024,1024,nodule,736,551,805,643,,69,92
00006273_002.jpg,1024,1024,nodule,119,636,189,717,,70,81
00006273_002.jpg,1024,1024,nodule,783,641,849,723,,66,82
00006330_006.jpg,1024,1024,nodule,99,685,220,772,,121,87
00006330_006.jpg,1024,1024,nodule,166,391,201,416,,35,25
00006330_006.jpg,1024,1024,nodule,230,241,309,304,,79,63
00006338_006.jpg,1024,1024,nodule,112,602,241,695,,129,93
00006338_007.jpg,1024,1024,nodule,234,531,313,610,,79,79
00006360_002.jpg,1024,1024,nodule,783,416,850,491,,67,75
00006360_002.jpg,1024,1024,nodule,794,614,866,692,,72,78
00006360_002.jpg,1024,1024,nodule,758,693,834,765,,76,72
00006458_000.jpg,1024,1024,nodule,296,226,399,335,,103,109
00006458_000.jpg,1024,1024,nodule,330,394,451,490,,121,96
00006458_000.jpg,1024,1024,nodule,749,470,816,541,,67,71
00006458_000.jpg,1024,1024,nodule,733,568,793,650,,60,82
00006458_000.jpg,1024,1024,nodule,792,694,860,769,,68,75
00006471_000.jpg,1024,1024,nodule,231,451,285,497,,54,46
00006471_002.jpg,1024,1024,nodule,129,442,165,467,,36,25
00006558_000.jpg,1024,1024,nodule,537,293,671,415,,134,122
00006558_000.jpg,1024,1024,nodule,193,269,436,497,,243,228
00006558_000.jpg,1024,1024,nodule,551,364,724,516,,173,152
00006558_000.jpg,1024,1024,nodule,317,476,435,564,,118,88
00006558_000.jpg,1024,1024,nodule,194,539,316,646,,122,107
00006558_000.jpg,1024,1024,nodule,617,546,724,646,,107,100
00006558_000.jpg,1024,1024,nodule,758,329,818,376,,60,47
00006558_000.jpg,1024,1024,nodule,731,441,789,482,,58,41
00006558_000.jpg,1024,1024,nodule,638,230,720,295,,82,65
00006558_000.jpg,1024,1024,nodule,639,334,709,393,,70,59
00006558_000.jpg,1024,1024,nodule,689,320,765,379,,76,59
00006558_000.jpg,1024,1024,nodule,729,374,812,434,,83,60
00006558_000.jpg,1024,1024,nodule,795,390,863,441,,68,51
00006558_000.jpg,1024,1024,nodule,148,425,238,490,,90,65
00006558_000.jpg,1024,1024,nodule,235,485,311,544,,76,59
00006558_000.jpg,1024,1024,nodule,514,554,594,622,,80,68
00006558_000.jpg,1024,1024,nodule,729,558,801,620,,72,62
00006558_000.jpg,1024,1024,nodule,595,608,664,676,,69,68
00006558_000.jpg,1024,1024,nodule,754,617,830,681,,76,64
00006558_000.jpg,1024,1024,nodule,692,631,770,703,,78,72
00006791_006.jpg,1024,1024,nodule,719,308,769,360,,50,52
00006791_006.jpg,1024,1024,nodule,136,510,185,563,,49,53
00006794_002.jpg,1024,1024,nodule,692,731,816,849,,124,118
00006829_010.jpg,1024,1024,nodule,642,150,813,322,,171,172
00006829_010.jpg,1024,1024,nodule,318,274,464,403,,146,129
00006829_010.jpg,1024,1024,nodule,731,340,855,449,,124,109
00006829_010.jpg,1024,1024,nodule,218,205,268,252,,50,47
00006829_010.jpg,1024,1024,nodule,241,254,298,301,,57,47
00006829_010.jpg,1024,1024,nodule,174,374,228,421,,54,47
00006829_010.jpg,1024,1024,nodule,825,485,882,535,,57,50
00006829_010.jpg,1024,1024,nodule,882,560,939,607,,57,47
00006829_010.jpg,1024,1024,nodule,779,202,873,266,,94,64
00006829_010.jpg,1024,1024,nodule,229,291,307,353,,78,62
00006829_010.jpg,1024,1024,nodule,789,313,872,377,,83,64
00006829_010.jpg,1024,1024,nodule,833,358,910,420,,77,62
00006829_010.jpg,1024,1024,nodule,148,424,226,490,,78,66
00006829_010.jpg,1024,1024,nodule,786,566,870,632,,84,66
00006833_002.jpg,1024,1024,nodule,834,675,915,745,,81,70
00006851_007.jpg,1024,1024,nodule,235,548,300,620,,65,72
00006903_001.jpg,1024,1024,nodule,578,581,610,622,,32,41
00006925_004.jpg,1024,1024,nodule,284,141,332,193,,48,52
00006925_004.jpg,1024,1024,nodule,685,175,738,225,,53,50
00006925_004.jpg,1024,1024,nodule,656,561,705,614,,49,53
00006925_004.jpg,1024,1024,nodule,618,672,687,739,,69,67
00006952_005.jpg,1024,1024,nodule,183,298,217,336,,34,38
00007057_002.jpg,1024,1024,nodule,360,218,468,317,,108,99
00007057_002.jpg,1024,1024,nodule,320,440,434,537,,114,97
00007057_002.jpg,1024,1024,nodule,212,453,271,500,,59,47
00007057_002.jpg,1024,1024,nodule,217,266,289,335,,72,69
00007057_002.jpg,1024,1024,nodule,719,408,809,487,,90,79
00007057_002.jpg,1024,1024,nodule,255,422,333,487,,78,65
00007065_001.jpg,1024,1024,nodule,165,361,237,431,,72,70
00007209_001.jpg,1024,1024,nodule,690,269,747,312,,57,43
00007281_000.jpg,1024,1024,nodule,769,263,818,318,,49,55
00007281_000.jpg,1024,1024,nodule,723,541,769,596,,46,55
00007281_000.jpg,1024,1024,nodule,179,568,229,617,,50,49
00007283_004.jpg,1024,1024,nodule,207,536,316,663,,109,127
00007283_004.jpg,1024,1024,nodule,200,627,306,740,,106,113
00007283_004.jpg,1024,1024,nodule,168,690,217,744,,49,54
00007283_004.jpg,1024,1024,nodule,149,810,197,865,,48,55
00007283_004.jpg,1024,1024,nodule,797,626,859,712,,62,86
00007321_013.jpg,1024,1024,nodule,760,632,836,702,,76,70
00007454_002.jpg,1024,1024,nodule,246,350,294,403,,48,53
00007454_002.jpg,1024,1024,nodule,855,854,902,908,,47,54
00007454_002.jpg,1024,1024,nodule,809,715,874,791,,65,76
00007501_001.jpg,1024,1024,nodule,617,267,736,369,,119,102
00007501_001.jpg,1024,1024,nodule,309,189,363,240,,54,51
00007501_001.jpg,1024,1024,nodule,675,192,735,238,,60,46
00007501_001.jpg,1024,1024,nodule,773,210,830,253,,57,43
00007501_001.jpg,1024,1024,nodule,268,374,331,416,,63,42
00007501_001.jpg,1024,1024,nodule,252,316,339,379,,87,63
00007501_001.jpg,1024,1024,nodule,708,553,789,617,,81,64
00007501_001.jpg,1024,1024,nodule,173,608,250,677,,77,69
00007501_004.jpg,1024,1024,nodule,144,281,317,415,,173,134
00007501_004.jpg,1024,1024,nodule,598,291,735,428,,137,137
00007501_004.jpg,1024,1024,nodule,664,229,719,279,,55,50
00007501_004.jpg,1024,1024,nodule,769,260,823,305,,54,45
00007501_004.jpg,1024,1024,nodule,249,398,312,441,,63,43
00007501_004.jpg,1024,1024,nodule,676,586,733,631,,57,45
00007501_004.jpg,1024,1024,nodule,270,209,358,279,,88,70
00007501_004.jpg,1024,1024,nodule,751,603,837,672,,86,69
00007731_006.jpg,1024,1024,nodule,205,183,346,280,,141,97
00007731_006.jpg,1024,1024,nodule,768,284,882,381,,114,97
00007731_006.jpg,1024,1024,nodule,194,370,349,469,,155,99
00007731_006.jpg,1024,1024,nodule,676,241,731,286,,55,45
00007731_006.jpg,1024,1024,nodule,663,279,718,327,,55,48
00007731_006.jpg,1024,1024,nodule,736,273,789,319,,53,46
00007731_006.jpg,1024,1024,nodule,798,520,881,581,,83,61
00007731_006.jpg,1024,1024,nodule,818,569,908,640,,90,71
00007732_000.jpg,1024,1024,nodule,789,315,842,363,,53,48
00008101_000.jpg,1024,1024,nodule,246,520,313,603,,67,83
00008101_000.jpg,1024,1024,nodule,755,736,824,805,,69,69
00008188_003.jpg,1024,1024,nodule,181,708,279,818,,98,110
00008191_005.jpg,1024,1024,nodule,259,351,308,405,,49,54
00008544_000.jpg,1024,1024,nodule,214,525,394,730,,180,205
00008544_000.jpg,1024,1024,nodule,134,423,207,512,,73,89
00008675_007.jpg,1024,1024,nodule,627,495,678,546,,51,51
00008675_007.jpg,1024,1024,nodule,270,445,341,511,,71,66
00008701_036.jpg,1024,1024,nodule,237,403,285,456,,48,53
00008732_001.jpg,1024,1024,nodule,212,755,261,809,,49,54
00008732_001.jpg,1024,1024,nodule,837,766,899,843,,62,77
00008892_003.jpg,1024,1024,nodule,306,520,372,599,,66,79
00008892_003.jpg,1024,1024,nodule,197,697,270,770,,73,73
00008893_000.jpg,1024,1024,nodule,172,536,216,593,,44,57
00008947_001.jpg,1024,1024,nodule,792,191,869,252,,77,61
00008947_001.jpg,1024,1024,nodule,566,593,636,666,,70,73
00008947_001.jpg,1024,1024,nodule,796,592,868,663,,72,71
00008947_001.jpg,1024,1024,nodule,257,686,346,755,,89,69
00008947_001.jpg,1024,1024,nodule,764,675,842,746,,78,71
00008948_000.jpg,1024,1024,nodule,704,204,757,251,,53,47
00008948_000.jpg,1024,1024,nodule,219,453,278,498,,59,45
00008948_000.jpg,1024,1024,nodule,252,392,327,459,,75,67
00008948_000.jpg,1024,1024,nodule,167,590,248,656,,81,66
00009019_001.jpg,1024,1024,nodule,422,336,471,387,,49,51
00009019_001.jpg,1024,1024,nodule,198,467,230,496,,32,29
00009019_001.jpg,1024,1024,nodule,318,449,391,525,,73,76
00009019_001.jpg,1024,1024,nodule,248,617,321,685,,73,68
00009403_006.jpg,1024,1024,nodule,773,412,823,463,,50,51
00009403_006.jpg,1024,1024,nodule,672,443,742,523,,70,80
00009403_007.jpg,1024,1024,nodule,748,222,798,273,,50,51
00009403_007.jpg,1024,1024,nodule,248,429,303,478,,55,49
00009403_007.jpg,1024,1024,nodule,162,716,209,769,,47,53
00009403_007.jpg,1024,1024,nodule,700,663,767,746,,67,83
00009431_017.jpg,1024,1024,nodule,709,295,782,374,,73,79
00009461_001.jpg,1024,1024,nodule,723,263,771,317,,48,54
00009690_002.jpg,1024,1024,nodule,766,569,812,623,,46,54
00009690_002.jpg,1024,1024,nodule,752,442,820,525,,68,83
00009690_002.jpg,1024,1024,nodule,217,472,290,547,,73,75
00009690_002.jpg,1024,1024,nodule,306,654,392,728,,86,74
00009690_002.jpg,1024,1024,nodule,346,624,417,701,,71,77
00009690_002.jpg,1024,1024,nodule,810,637,878,723,,68,86
00009875_006.jpg,1024,1024,nodule,282,271,336,317,,54,46
00009875_006.jpg,1024,1024,nodule,878,504,929,555,,51,51
00009875_006.jpg,1024,1024,nodule,847,730,904,774,,57,44
00009875_006.jpg,1024,1024,nodule,649,538,729,616,,80,78
00009875_006.jpg,1024,1024,nodule,829,668,902,740,,73,72
00009875_006.jpg,1024,1024,nodule,252,301,283,332,,31,31
00010196_000.jpg,1024,1024,nodule,251,376,306,424,,55,48
00010196_000.jpg,1024,1024,nodule,78,611,130,659,,52,48
00010277_000.jpg,1024,1024,nodule,678,413,909,624,,231,211
00010277_000.jpg,1024,1024,nodule,768,304,848,379,,80,75
00010277_000.jpg,1024,1024,nodule,278,387,359,455,,81,68
00010277_000.jpg,1024,1024,nodule,629,466,713,545,,84,79
00010507_006.jpg,1024,1024,nodule,224,442,333,582,,109,140
00010516_001.jpg,1024,1024,nodule,756,581,824,660,,68,79
00010592_003.jpg,1024,1024,nodule,789,528,872,591,,83,63
00010634_007.jpg,1024,1024,nodule,287,234,338,283,,51,49
00010634_007.jpg,1024,1024,nodule,770,443,820,492,,50,49
00010634_007.jpg,1024,1024,nodule,283,641,335,689,,52,48
00010634_007.jpg,1024,1024,nodule,165,693,220,739,,55,46
00010634_007.jpg,1024,1024,nodule,365,233,438,302,,73,69
00010634_007.jpg,1024,1024,nodule,677,466,743,536,,66,70
00010634_007.jpg,1024,1024,nodule,234,415,300,484,,66,69
00010634_007.jpg,1024,1024,nodule,285,585,343,638,,58,53
00010634_007.jpg,1024,1024,nodule,232,620,291,675,,59,55
00010775_005.jpg,1024,1024,nodule,329,449,384,497,,55,48
00010775_005.jpg,1024,1024,nodule,204,476,265,518,,61,42
00010775_005.jpg,1024,1024,nodule,375,371,456,444,,81,73
00010775_005.jpg,1024,1024,nodule,225,398,298,463,,73,65
00010775_005.jpg,1024,1024,nodule,290,461,358,530,,68,69
00010775_005.jpg,1024,1024,nodule,196,546,279,613,,83,67
00010775_005.jpg,1024,1024,nodule,135,685,204,753,,69,68
00010775_005.jpg,1024,1024,nodule,257,715,326,783,,69,68
00010775_005.jpg,1024,1024,nodule,264,764,339,837,,75,73
00010814_009.jpg,1024,1024,nodule,889,606,924,646,,35,40
00010814_009.jpg,1024,1024,nodule,823,640,860,678,,37,38
00010887_021.jpg,1024,1024,nodule,330,182,367,221,,37,39
00010887_021.jpg,1024,1024,nodule,383,263,416,304,,33,41
00010887_021.jpg,1024,1024,nodule,808,644,844,681,,36,37
00010887_021.jpg,1024,1024,nodule,262,208,294,234,,32,26
00010959_011.jpg,1024,1024,nodule,746,596,796,643,,50,47
00010959_011.jpg,1024,1024,nodule,187,641,242,690,,55,49
00010959_011.jpg,1024,1024,nodule,259,386,326,459,,67,73
00010959_011.jpg,1024,1024,nodule,285,561,361,639,,76,78
00010959_011.jpg,1024,1024,nodule,799,610,874,678,,75,68
00010959_011.jpg,1024,1024,nodule,235,628,318,702,,83,74
00010959_011.jpg,1024,1024,nodule,686,635,767,705,,81,70
00010959_011.jpg,1024,1024,nodule,844,688,921,765,,77,77
00010959_011.jpg,1024,1024,nodule,153,684,220,738,,67,54
00011270_000.jpg,1024,1024,nodule,246,360,295,414,,49,54
00011270_000.jpg,1024,1024,nodule,186,411,237,464,,51,53
00011270_000.jpg,1024,1024,nodule,188,477,241,525,,53,48
00011270_000.jpg,1024,1024,nodule,143,803,195,851,,52,48
00011270_000.jpg,1024,1024,nodule,834,632,906,704,,72,72
00011270_000.jpg,1024,1024,nodule,112,797,189,864,,77,67
00011353_000.jpg,1024,1024,nodule,298,380,377,457,,79,77
00011353_000.jpg,1024,1024,nodule,672,497,756,567,,84,70
00011379_047.jpg,1024,1024,nodule,166,506,252,573,,86,67
00011548_000.jpg,1024,1024,nodule,747,477,801,526,,54,49
00011548_000.jpg,1024,1024,nodule,229,529,279,580,,50,51
00011588_000.jpg,1024,1024,nodule,758,342,811,389,,53,47
00011588_000.jpg,1024,1024,nodule,284,356,339,405,,55,49
00011588_000.jpg,1024,1024,nodule,710,455,761,505,,51,50
00011588_000.jpg,1024,1024,nodule,784,629,843,676,,59,47
00011588_000.jpg,1024,1024,nodule,319,241,391,309,,72,68
00011588_000.jpg,1024,1024,nodule,225,533,298,599,,73,66
00011588_000.jpg,1024,1024,nodule,804,630,888,695,,84,65
00011621_001.jpg,1024,1024,nodule,215,163,272,206,,57,43
00011804_017.jpg,1024,1024,nodule,222,294,398,495,,176,201
00011804_017.jpg,1024,1024,nodule,145,606,283,741,,138,135
00011804_017.jpg,1024,1024,nodule,300,612,378,680,,78,68
00011811_004.jpg,1024,1024,nodule,600,181,735,327,,135,146
00011811_004.jpg,1024,1024,nodule,376,332,504,446,,128,114
00011811_004.jpg,1024,1024,nodule,640,371,778,485,,138,114
00011811_004.jpg,1024,1024,nodule,787,397,901,524,,114,127
00011811_004.jpg,1024,1024,nodule,217,522,444,657,,227,135
00011811_004.jpg,1024,1024,nodule,579,493,859,693,,280,200
00011811_004.jpg,1024,1024,nodule,215,621,350,733,,135,112
00011811_004.jpg,1024,1024,nodule,274,330,329,378,,55,48
00011811_004.jpg,1024,1024,nodule,256,380,311,421,,55,41
00011811_004.jpg,1024,1024,nodule,304,423,364,465,,60,42
00011811_004.jpg,1024,1024,nodule,721,245,800,312,,79,67
00011811_004.jpg,1024,1024,nodule,316,301,399,380,,83,79
00011811_004.jpg,1024,1024,nodule,678,311,774,376,,96,65
00011811_004.jpg,1024,1024,nodule,221,403,302,481,,81,78
00011811_004.jpg,1024,1024,nodule,393,431,468,501,,75,70
00011811_004.jpg,1024,1024,nodule,332,657,418,718,,86,61
00011878_000.jpg,1024,1024,nodule,739,724,788,776,,49,52
00011885_000.jpg,1024,1024,nodule,660,220,714,268,,54,48
00011885_000.jpg,1024,1024,nodule,622,263,696,329,,74,66
00011885_002.jpg,1024,1024,nodule,229,608,310,681,,81,73
00011885_002.jpg,1024,1024,nodule,898,657,967,729,,69,72
00011963_004.jpg,1024,1024,nodule,846,584,903,629,,57,45
00012045_052.jpg,1024,1024,nodule,135,550,242,648,,107,98
00012045_052.jpg,1024,1024,nodule,243,577,359,669,,116,92
00012045_052.jpg,1024,1024,nodule,188,393,242,443,,54,50
00012045_052.jpg,1024,1024,nodule,678,312,749,382,,71,70
00012045_052.jpg,1024,1024,nodule,302,364,379,428,,77,64
00012045_052.jpg,1024,1024,nodule,700,416,786,490,,86,74
00012045_052.jpg,1024,1024,nodule,234,475,323,550,,89,75
00012087_017.jpg,1024,1024,nodule,266,683,318,732,,52,49
00012087_017.jpg,1024,1024,nodule,779,742,828,794,,49,52
00012087_017.jpg,1024,1024,nodule,757,624,825,697,,68,73
00012087_017.jpg,1024,1024,nodule,679,773,746,845,,67,72
00012161_002.jpg,1024,1024,nodule,288,219,394,327,,106,108
00012261_000.jpg,1024,1024,nodule,725,335,775,385,,50,50
00012486_001.jpg,1024,1024,nodule,699,335,808,439,,109,104
00012486_001.jpg,1024,1024,nodule,245,615,364,720,,119,105
00012486_001.jpg,1024,1024,nodule,765,180,805,217,,40,37
00012486_001.jpg,1024,1024,nodule,699,222,748,274,,49,52
00012486_001.jpg,1024,1024,nodule,771,237,825,284,,54,47
00012486_001.jpg,1024,1024,nodule,764,284,819,332,,55,48
00012486_001.jpg,1024,1024,nodule,852,372,903,421,,51,49
00012486_001.jpg,1024,1024,nodule,323,401,378,452,,55,51
00012486_001.jpg,1024,1024,nodule,351,472,407,523,,56,51
00012486_001.jpg,1024,1024,nodule,198,526,249,576,,51,50
00012486_001.jpg,1024,1024,nodule,790,573,844,620,,54,47
00012486_001.jpg,1024,1024,nodule,222,742,279,788,,57,46
00012486_001.jpg,1024,1024,nodule,637,390,717,466,,80,76
00012486_001.jpg,1024,1024,nodule,706,445,792,505,,86,60
00012486_001.jpg,1024,1024,nodule,707,488,790,558,,83,70
00012486_001.jpg,1024,1024,nodule,266,515,344,580,,78,65
00012486_001.jpg,1024,1024,nodule,839,511,915,578,,76,67
00012486_001.jpg,1024,1024,nodule,267,697,346,761,,79,64
00012659_012.jpg,1024,1024,nodule,739,245,793,292,,54,47
00012700_000.jpg,1024,1024,nodule,168,406,226,451,,58,45
00012892_009.jpg,1024,1024,nodule,354,283,452,385,,98,102
00012892_009.jpg,1024,1024,nodule,601,585,652,634,,51,49
00012924_000.jpg,1024,1024,nodule,233,477,396,631,,163,154
00012924_000.jpg,1024,1024,nodule,816,592,897,656,,81,64
00012924_000.jpg,1024,1024,nodule,373,633,434,708,,61,75
00012924_000.jpg,1024,1024,nodule,304,662,377,736,,73,74
00012924_000.jpg,1024,1024,nodule,416,397,474,454,,58,57
00012924_000.jpg,1024,1024,nodule,292,415,333,446,,41,31
00012973_008.jpg,1024,1024,nodule,280,583,356,651,,76,68
00012973_008.jpg,1024,1024,nodule,329,646,399,725,,70,79
00013061_000.jpg,1024,1024,nodule,839,428,910,495,,71,67
00013167_000.jpg,1024,1024,nodule,789,275,845,322,,56,47
00013167_000.jpg,1024,1024,nodule,800,654,876,722,,76,68
00013231_000.jpg,1024,1024,nodule,661,235,713,284,,52,49
00013231_000.jpg,1024,1024,nodule,746,559,798,609,,52,50
00013231_000.jpg,1024,1024,nodule,329,756,400,828,,71,72
00013237_000.jpg,1024,1024,nodule,193,511,333,612,,140,101
00013237_000.jpg,1024,1024,nodule,702,598,825,724,,123,126
00013237_000.jpg,1024,1024,nodule,301,371,359,416,,58,45
00013237_000.jpg,1024,1024,nodule,733,360,789,406,,56,46
00013237_000.jpg,1024,1024,nodule,790,350,842,395,,52,45
00013237_000.jpg,1024,1024,nodule,714,234,802,301,,88,67
00013237_000.jpg,1024,1024,nodule,787,313,860,377,,73,64
00013237_000.jpg,1024,1024,nodule,184,343,265,405,,81,62
00013237_000.jpg,1024,1024,nodule,558,429,640,498,,82,69
00013237_000.jpg,1024,1024,nodule,730,435,808,500,,78,65
00013237_000.jpg,1024,1024,nodule,146,482,248,537,,102,55
00013237_000.jpg,1024,1024,nodule,86,531,172,596,,86,65
00013237_000.jpg,1024,1024,nodule,834,517,907,591,,73,74
00013237_000.jpg,1024,1024,nodule,179,569,263,632,,84,63
00013237_000.jpg,1024,1024,nodule,117,584,218,652,,101,68
00013392_000.jpg,1024,1024,nodule,259,493,311,543,,52,50
00013392_000.jpg,1024,1024,nodule,215,575,295,645,,80,70
00013463_001.jpg,1024,1024,nodule,777,608,847,692,,70,84
00013463_001.jpg,1024,1024,nodule,191,745,265,820,,74,75
00013499_000.jpg,1024,1024,nodule,256,328,435,526,,179,198
00013499_000.jpg,1024,1024,nodule,510,340,632,446,,122,106
00013499_000.jpg,1024,1024,nodule,169,538,286,641,,117,103
00013499_000.jpg,1024,1024,nodule,603,424,713,500,,110,76
00013499_000.jpg,1024,1024,nodule,268,229,322,278,,54,49
00013499_000.jpg,1024,1024,nodule,581,243,644,285,,63,42
00013499_000.jpg,1024,1024,nodule,635,279,687,330,,52,51
00013499_000.jpg,1024,1024,nodule,631,327,686,377,,55,50
00013499_000.jpg,1024,1024,nodule,627,202,707,272,,80,70
00013499_000.jpg,1024,1024,nodule,682,276,761,348,,79,72
00013499_000.jpg,1024,1024,nodule,225,306,298,373,,73,67
00013499_000.jpg,1024,1024,nodule,237,404,320,470,,83,66
00013499_000.jpg,1024,1024,nodule,143,475,217,551,,74,76
00013499_000.jpg,1024,1024,nodule,302,510,369,580,,67,70
00013499_000.jpg,1024,1024,nodule,329,612,418,691,,89,79
00013499_000.jpg,1024,1024,nodule,224,629,307,693,,83,64
00013499_000.jpg,1024,1024,nodule,279,696,361,760,,82,64
00013499_000.jpg,1024,1024,nodule,708,578,827,661,,119,83
00013499_000.jpg,1024,1024,nodule,744,424,814,497,,70,73
00013499_000.jpg,1024,1024,nodule,703,507,786,589,,83,82
00013499_000.jpg,1024,1024,nodule,665,490,754,572,,89,82
00013499_000.jpg,1024,1024,nodule,538,593,662,682,,124,89
00013499_000.jpg,1024,1024,nodule,623,587,736,697,,113,110
00013499_000.jpg,1024,1024,nodule,615,531,698,611,,83,80
00013655_005.jpg,1024,1024,nodule,323,489,440,585,,117,96
00013655_005.jpg,1024,1024,nodule,141,370,192,420,,51,50
00013655_005.jpg,1024,1024,nodule,150,288,233,362,,83,74
00013655_005.jpg,1024,1024,nodule,715,539,795,605,,80,66
00013714_009.jpg,1024,1024,nodule,891,561,967,629,,76,68
00013885_000.jpg,1024,1024,nodule,433,268,485,317,,52,49
00013904_002.jpg,1024,1024,nodule,622,362,676,412,,54,50
00013904_002.jpg,1024,1024,nodule,845,437,897,486,,52,49
00013904_002.jpg,1024,1024,nodule,373,233,455,317,,82,84
00013904_002.jpg,1024,1024,nodule,757,277,832,347,,75,70
00013904_002.jpg,1024,1024,nodule,731,349,810,424,,79,75
00013904_002.jpg,1024,1024,nodule,838,507,908,584,,70,77
00013904_004.jpg,1024,1024,nodule,233,529,287,576,,54,47
00013904_004.jpg,1024,1024,nodule,760,596,813,644,,53,48
00013904_004.jpg,1024,1024,nodule,649,670,704,720,,55,50
00013904_004.jpg,1024,1024,nodule,331,212,416,293,,85,81
00013904_004.jpg,1024,1024,nodule,284,280,353,350,,69,70
00013904_004.jpg,1024,1024,nodule,713,263,786,328,,73,65
00013904_004.jpg,1024,1024,nodule,675,327,758,405,,83,78
00013904_004.jpg,1024,1024,nodule,187,369,258,438,,71,69
00013904_004.jpg,1024,1024,nodule,331,273,452,427,,121,154
00013904_004.jpg,1024,1024,nodule,644,430,715,494,,71,64
00013904_004.jpg,1024,1024,nodule,709,465,780,537,,71,72
00013904_004.jpg,1024,1024,nodule,674,520,742,589,,68,69
00013904_004.jpg,1024,1024,nodule,776,501,850,578,,74,77
00013904_004.jpg,1024,1024,nodule,586,560,660,636,,74,76
00013904_004.jpg,1024,1024,nodule,685,558,755,636,,70,78
00013904_004.jpg,1024,1024,nodule,364,613,436,682,,72,69
00013904_004.jpg,1024,1024,nodule,566,589,640,667,,74,78
00013904_004.jpg,1024,1024,nodule,805,588,879,666,,74,78
00013904_004.jpg,1024,1024,nodule,214,450,280,522,,66,72
00013904_006.jpg,1024,1024,nodule,299,256,352,308,,53,52
00013904_006.jpg,1024,1024,nodule,730,235,784,287,,54,52
00013904_006.jpg,1024,1024,nodule,201,444,255,492,,54,48
00013904_006.jpg,1024,1024,nodule,237,446,290,497,,53,51
00013904_006.jpg,1024,1024,nodule,348,187,417,262,,69,75
00013904_006.jpg,1024,1024,nodule,182,326,255,392,,73,66
00013904_006.jpg,1024,1024,nodule,691,308,761,376,,70,68
00013904_006.jpg,1024,1024,nodule,727,306,803,369,,76,63
00013951_004.jpg,1024,1024,nodule,221,211,277,257,,56,46
00014123_000.jpg,1024,1024,nodule,626,261,701,328,,75,67
00014203_015.jpg,1024,1024,nodule,218,298,331,422,,113,124
00014298_000.jpg,1024,1024,nodule,252,329,309,381,,57,52
00014298_000.jpg,1024,1024,nodule,229,401,280,448,,51,47
00014298_000.jpg,1024,1024,nodule,335,317,408,382,,73,65
00014298_000.jpg,1024,1024,nodule,717,336,787,412,,70,76
00014298_000.jpg,1024,1024,nodule,324,388,393,452,,69,64
00014298_000.jpg,1024,1024,nodule,749,464,818,537,,69,73
00014298_000.jpg,1024,1024,nodule,794,526,862,603,,68,77
00014298_000.jpg,1024,1024,nodule,706,699,780,772,,74,73
00014306_004.jpg,1024,1024,nodule,720,580,827,692,,107,112
00014334_000.jpg,1024,1024,nodule,833,716,903,790,,70,74
00014358_003.jpg,1024,1024,nodule,243,558,372,709,,129,151
00014358_003.jpg,1024,1024,nodule,513,778,582,853,,69,75
00014454_006.jpg,1024,1024,nodule,832,699,903,784,,71,85
00014567_001.jpg,1024,1024,nodule,352,276,427,345,,75,69
00014663_000.jpg,1024,1024,nodule,257,469,379,566,,122,97
00014663_000.jpg,1024,1024,nodule,681,426,756,502,,75,76
00014663_000.jpg,1024,1024,nodule,190,573,241,618,,51,45
00014663_000.jpg,1024,1024,nodule,192,614,241,655,,49,41
00014663_000.jpg,1024,1024,nodule,267,722,339,799,,72,77
00014663_000.jpg,1024,1024,nodule,768,710,840,784,,72,74
00014663_000.jpg,1024,1024,nodule,361,761,432,838,,71,77
00014663_000.jpg,1024,1024,nodule,813,780,881,853,,68,73
00014663_000.jpg,1024,1024,nodule,267,812,340,889,,73,77
00014663_000.jpg,1024,1024,nodule,176,857,257,929,,81,72
00014663_057.jpg,1024,1024,nodule,251,323,360,433,,109,110
00014663_057.jpg,1024,1024,nodule,801,369,848,420,,47,51
00014663_057.jpg,1024,1024,nodule,701,299,766,381,,65,82
00014663_057.jpg,1024,1024,nodule,772,422,840,503,,68,81
00014731_010.jpg,1024,1024,nodule,712,311,822,414,,110,103
00014731_010.jpg,1024,1024,nodule,749,585,863,694,,114,109
00014731_010.jpg,1024,1024,nodule,270,518,333,593,,63,75
00014758_006.jpg,1024,1024,nodule,345,199,397,247,,52,48
00014758_006.jpg,1024,1024,nodule,210,391,264,436,,54,45
00014758_006.jpg,1024,1024,nodule,814,498,867,547,,53,49
00014758_006.jpg,1024,1024,nodule,156,584,212,629,,56,45
00014758_006.jpg,1024,1024,nodule,225,327,300,395,,75,68
00014758_006.jpg,1024,1024,nodule,160,457,234,521,,74,64
00014758_006.jpg,1024,1024,nodule,721,518,792,585,,71,67
00014758_006.jpg,1024,1024,nodule,834,550,901,618,,67,68
00014758_006.jpg,1024,1024,nodule,752,591,829,661,,77,70
00014758_006.jpg,1024,1024,nodule,808,595,888,661,,80,66
00014758_006.jpg,1024,1024,nodule,159,646,238,717,,79,71
00014758_006.jpg,1024,1024,nodule,800,655,878,721,,78,66
00014758_006.jpg,1024,1024,nodule,872,632,944,710,,72,78
00014758_006.jpg,1024,1024,nodule,239,680,316,747,,77,67
00014758_006.jpg,1024,1024,nodule,593,689,664,764,,71,75
00014758_006.jpg,1024,1024,nodule,145,717,228,782,,83,65
00014758_006.jpg,1024,1024,nodule,844,733,938,800,,94,67
00014826_000.jpg,1024,1024,nodule,308,543,463,718,,155,175
00014826_000.jpg,1024,1024,nodule,596,214,663,291,,67,77
00014826_000.jpg,1024,1024,nodule,678,312,753,392,,75,80
00014826_000.jpg,1024,1024,nodule,276,438,346,508,,70,70
00014826_000.jpg,1024,1024,nodule,778,550,847,633,,69,83
00014826_000.jpg,1024,1024,nodule,630,654,704,730,,74,76
00014826_000.jpg,1024,1024,nodule,805,644,870,723,,65,79
00014826_000.jpg,1024,1024,nodule,815,737,880,807,,65,70
00014865_001.jpg,1024,1024,nodule,190,531,238,587,,48,56
00014881_000.jpg,1024,1024,nodule,246,560,319,628,,73,68
00014895_001.jpg,1024,1024,nodule,225,591,304,656,,79,65
00015029_001.jpg,1024,1024,nodule,676,541,784,669,,108,128
00015029_001.jpg,1024,1024,nodule,705,480,775,568,,70,88
00015113_002.jpg,1024,1024,nodule,291,627,376,705,,85,78
00015113_005.jpg,1024,1024,nodule,696,493,769,562,,73,69
00015113_005.jpg,1024,1024,nodule,241,571,320,640,,79,69
00015136_000.jpg,1024,1024,nodule,739,401,790,451,,51,50
00015136_000.jpg,1024,1024,nodule,381,167,457,232,,76,65
00015268_000.jpg,1024,1024,nodule,197,586,234,624,,37,38
00015310_001.jpg,1024,1024,nodule,647,350,790,521,,143,171
00015310_001.jpg,1024,1024,nodule,597,186,649,233,,52,47
00015454_000.jpg,1024,1024,nodule,240,425,292,472,,52,47
00015495_014.jpg,1024,1024,nodule,748,354,824,427,,76,73
00015506_002.jpg,1024,1024,nodule,331,435,382,492,,51,57
00015506_002.jpg,1024,1024,nodule,576,283,648,361,,72,78
00015506_002.jpg,1024,1024,nodule,280,356,346,429,,66,73
00015506_002.jpg,1024,1024,nodule,565,347,642,428,,77,81
00015506_002.jpg,1024,1024,nodule,286,482,360,560,,74,78
00015506_002.jpg,1024,1024,nodule,716,520,780,596,,64,76
00015506_002.jpg,1024,1024,nodule,646,565,715,645,,69,80
00015506_004.jpg,1024,1024,nodule,297,491,419,635,,122,144
00015506_004.jpg,1024,1024,nodule,330,649,447,771,,117,122
00015506_004.jpg,1024,1024,nodule,685,622,733,676,,48,54
00015506_004.jpg,1024,1024,nodule,593,226,656,301,,63,75
00015506_004.jpg,1024,1024,nodule,388,293,454,376,,66,83
00015506_004.jpg,1024,1024,nodule,610,320,684,408,,74,88
00015506_004.jpg,1024,1024,nodule,688,387,755,457,,67,70
00015506_004.jpg,1024,1024,nodule,307,421,371,496,,64,75
00015506_004.jpg,1024,1024,nodule,708,439,779,520,,71,81
00015506_004.jpg,1024,1024,nodule,262,641,328,715,,66,74
00015506_004.jpg,1024,1024,nodule,348,640,423,717,,75,77
00015506_004.jpg,1024,1024,nodule,712,665,763,723,,51,58
00015506_004.jpg,1024,1024,nodule,603,671,674,748,,71,77
00015506_004.jpg,1024,1024,nodule,630,667,705,748,,75,81
00015556_018.jpg,1024,1024,nodule,692,609,760,691,,68,82
00015556_020.jpg,1024,1024,nodule,588,631,658,707,,70,76
00015556_022.jpg,1024,1024,nodule,288,394,341,444,,53,50
00015563_006.jpg,1024,1024,nodule,599,608,678,683,,79,75
00015568_002.jpg,1024,1024,nodule,363,95,411,146,,48,51
00015568_002.jpg,1024,1024,nodule,224,281,272,336,,48,55
00015568_002.jpg,1024,1024,nodule,116,581,193,659,,77,78
00015568_002.jpg,1024,1024,nodule,698,659,773,729,,75,70
00015649_004.jpg,1024,1024,nodule,569,127,682,232,,113,105
00015649_004.jpg,1024,1024,nodule,546,277,666,407,,120,130
00015649_004.jpg,1024,1024,nodule,660,317,769,459,,109,142
00015649_004.jpg,1024,1024,nodule,665,244,740,316,,75,72
00015679_003.jpg,1024,1024,nodule,208,638,261,686,,53,48
00015679_003.jpg,1024,1024,nodule,774,323,841,398,,67,75
00015754_008.jpg,1024,1024,nodule,310,181,356,237,,46,56
00015754_008.jpg,1024,1024,nodule,718,505,786,586,,68,81
00015792_009.jpg,1024,1024,nodule,652,526,770,643,,118,117
00015792_009.jpg,1024,1024,nodule,165,580,359,704,,194,124
00015792_009.jpg,1024,1024,nodule,338,185,410,255,,72,70
00015792_009.jpg,1024,1024,nodule,551,188,631,264,,80,76
00015792_009.jpg,1024,1024,nodule,673,224,755,287,,82,63
00015792_009.jpg,1024,1024,nodule,195,265,274,334,,79,69
00015792_009.jpg,1024,1024,nodule,337,291,408,357,,71,66
00015792_009.jpg,1024,1024,nodule,260,312,331,383,,71,71
00015792_009.jpg,1024,1024,nodule,666,358,742,437,,76,79
00015792_009.jpg,1024,1024,nodule,289,408,376,485,,87,77
00015792_009.jpg,1024,1024,nodule,183,459,268,517,,85,58
00015792_009.jpg,1024,1024,nodule,667,444,731,515,,64,71
00015792_009.jpg,1024,1024,nodule,301,476,383,552,,82,76
00015792_009.jpg,1024,1024,nodule,139,516,226,593,,87,77
00015814_007.jpg,1024,1024,nodule,824,439,879,485,,55,46
00015831_005.jpg,1024,1024,nodule,679,636,759,718,,80,82
00015893_000.jpg,1024,1024,nodule,263,328,317,380,,54,52
00015893_000.jpg,1024,1024,nodule,314,298,388,364,,74,66
00015913_001.jpg,1024,1024,nodule,266,272,377,374,,111,102
00015913_001.jpg,1024,1024,nodule,178,318,294,413,,116,95
00015913_001.jpg,1024,1024,nodule,108,468,163,511,,55,43
00015913_001.jpg,1024,1024,nodule,696,287,774,353,,78,66
00015913_001.jpg,1024,1024,nodule,233,500,325,570,,92,70
00015920_002.jpg,1024,1024,nodule,225,538,307,621,,82,83
00015920_002.jpg,1024,1024,nodule,212,621,287,700,,75,79
00016019_000.jpg,1024,1024,nodule,338,484,410,555,,72,71
00016019_000.jpg,1024,1024,nodule,262,499,335,571,,73,72
00016019_007.jpg,1024,1024,nodule,683,437,832,597,,149,160
00016019_007.jpg,1024,1024,nodule,256,576,371,693,,115,117
00016019_007.jpg,1024,1024,nodule,691,219,740,267,,49,48
00016019_007.jpg,1024,1024,nodule,239,289,289,337,,50,48
00016019_007.jpg,1024,1024,nodule,742,276,793,332,,51,56
00016019_007.jpg,1024,1024,nodule,267,332,320,388,,53,56
00016019_007.jpg,1024,1024,nodule,700,310,747,365,,47,55
00016019_007.jpg,1024,1024,nodule,192,409,246,461,,54,52
00016019_007.jpg,1024,1024,nodule,173,467,221,524,,48,57
00016019_007.jpg,1024,1024,nodule,270,473,318,526,,48,53
00016019_007.jpg,1024,1024,nodule,194,528,246,576,,52,48
00016019_007.jpg,1024,1024,nodule,175,551,224,604,,49,53
00016019_007.jpg,1024,1024,nodule,668,583,718,634,,50,51
00016019_007.jpg,1024,1024,nodule,648,352,720,430,,72,78
00016019_007.jpg,1024,1024,nodule,237,378,301,449,,64,71
00016019_007.jpg,1024,1024,nodule,281,394,345,464,,64,70
00016019_007.jpg,1024,1024,nodule,750,433,824,506,,74,73
00016019_007.jpg,1024,1024,nodule,647,501,715,572,,68,71
00016019_007.jpg,1024,1024,nodule,784,552,860,631,,76,79
00016019_007.jpg,1024,1024,nodule,705,643,793,709,,88,66
00016019_007.jpg,1024,1024,nodule,165,678,237,757,,72,79
00016019_007.jpg,1024,1024,nodule,233,670,319,750,,86,80
00016019_007.jpg,1024,1024,nodule,190,767,272,836,,82,69
00016019_008.jpg,1024,1024,nodule,690,400,829,526,,139,126
00016019_008.jpg,1024,1024,nodule,718,236,769,283,,51,47
00016019_008.jpg,1024,1024,nodule,305,283,357,332,,52,49
00016019_008.jpg,1024,1024,nodule,755,276,806,327,,51,51
00016019_008.jpg,1024,1024,nodule,339,324,393,376,,54,52
00016019_008.jpg,1024,1024,nodule,731,313,778,367,,47,54
00016019_008.jpg,1024,1024,nodule,286,375,339,424,,53,49
00016019_008.jpg,1024,1024,nodule,695,360,745,411,,50,51
00016019_008.jpg,1024,1024,nodule,253,404,304,457,,51,53
00016019_008.jpg,1024,1024,nodule,242,442,291,496,,49,54
00016019_008.jpg,1024,1024,nodule,282,498,332,543,,50,45
00016019_008.jpg,1024,1024,nodule,321,395,386,463,,65,68
00016019_008.jpg,1024,1024,nodule,770,405,844,475,,74,70
00016019_008.jpg,1024,1024,nodule,252,504,317,581,,65,77
00016019_008.jpg,1024,1024,nodule,337,512,419,594,,82,82
00016019_008.jpg,1024,1024,nodule,309,591,392,668,,83,77
00016019_008.jpg,1024,1024,nodule,224,633,298,703,,74,70
00016117_000.jpg,1024,1024,nodule,125,440,420,806,,295,366
00016142_010.jpg,1024,1024,nodule,596,244,731,355,,135,111
00016142_010.jpg,1024,1024,nodule,577,383,778,557,,201,174
00016142_010.jpg,1024,1024,nodule,296,443,404,558,,108,115
00016142_010.jpg,1024,1024,nodule,219,587,344,681,,125,94
00016167_005.jpg,1024,1024,nodule,727,753,783,796,,56,43
00016440_000.jpg,1024,1024,nodule,413,763,463,815,,50,52
00016481_000.jpg,1024,1024,nodule,207,304,426,485,,219,181
00016481_000.jpg,1024,1024,nodule,731,367,932,560,,201,193
00016481_000.jpg,1024,1024,nodule,110,516,190,597,,80,81
00016481_000.jpg,1024,1024,nodule,217,523,295,591,,78,68
00016481_000.jpg,1024,1024,nodule,194,644,273,710,,79,66
00016481_000.jpg,1024,1024,nodule,242,687,320,752,,78,65
00016551_000.jpg,1024,1024,nodule,745,215,866,334,,121,119
00016551_000.jpg,1024,1024,nodule,250,521,451,674,,201,153
00016551_000.jpg,1024,1024,nodule,239,849,352,964,,113,115
00016551_000.jpg,1024,1024,nodule,674,255,726,307,,52,52
00016551_000.jpg,1024,1024,nodule,161,580,212,633,,51,53
00016551_000.jpg,1024,1024,nodule,811,616,864,667,,53,51
00016551_000.jpg,1024,1024,nodule,203,698,254,746,,51,48
00016551_000.jpg,1024,1024,nodule,796,678,848,732,,52,54
00016551_000.jpg,1024,1024,nodule,831,745,878,798,,47,53
00016551_000.jpg,1024,1024,nodule,363,762,410,813,,47,51
00016551_000.jpg,1024,1024,nodule,253,338,325,407,,72,69
00016551_000.jpg,1024,1024,nodule,706,424,775,494,,69,70
00016551_000.jpg,1024,1024,nodule,136,492,207,568,,71,76
00016551_000.jpg,1024,1024,nodule,211,507,286,580,,75,73
00016551_000.jpg,1024,1024,nodule,574,582,646,665,,72,83
00016551_000.jpg,1024,1024,nodule,702,696,763,773,,61,77
00016551_000.jpg,1024,1024,nodule,740,680,800,731,,60,51
00016551_000.jpg,1024,1024,nodule,186,734,254,809,,68,75
00016551_000.jpg,1024,1024,nodule,264,737,343,809,,79,72
00016551_000.jpg,1024,1024,nodule,139,957,211,1024,,72,67
00016556_001.jpg,1024,1024,nodule,706,575,842,734,,136,159
00016556_001.jpg,1024,1024,nodule,303,686,371,759,,68,73
00016556_002.jpg,1024,1024,nodule,704,471,834,614,,130,143
00016568_003.jpg,1024,1024,nodule,701,289,842,422,,141,133
00016568_033.jpg,1024,1024,nodule,743,347,871,457,,128,110
00016568_033.jpg,1024,1024,nodule,700,353,781,415,,81,62
00016568_051.jpg,1024,1024,nodule,295,473,421,606,,126,133
00016568_051.jpg,1024,1024,nodule,163,536,304,668,,141,132
00016568_051.jpg,1024,1024,nodule,297,664,373,734,,76,70
00016568_052.jpg,1024,1024,nodule,281,593,404,749,,123,156
00016568_052.jpg,1024,1024,nodule,181,644,299,807,,118,163
00016587_060.jpg,1024,1024,nodule,680,592,788,696,,108,104
00016587_079.jpg,1024,1024,nodule,668,360,776,470,,108,110
00016700_000.jpg,1024,1024,nodule,706,565,763,614,,57,49
00016798_009.jpg,1024,1024,nodule,228,453,268,489,,40,36
00016805_007.jpg,1024,1024,nodule,749,425,831,487,,82,62
00016805_008.jpg,1024,1024,nodule,725,373,776,421,,51,48
00016805_008.jpg,1024,1024,nodule,754,453,826,524,,72,71
00016805_009.jpg,1024,1024,nodule,727,293,778,343,,51,50
00016805_009.jpg,1024,1024,nodule,757,376,826,449,,69,73
00016967_000.jpg,1024,1024,nodule,629,567,707,632,,78,65
00016971_012.jpg,1024,1024,nodule,738,258,850,379,,112,121
00016971_012.jpg,1024,1024,nodule,723,435,881,600,,158,165
00016980_000.jpg,1024,1024,nodule,137,725,169,768,,32,43
00016980_000.jpg,1024,1024,nodule,169,808,213,864,,44,56
00016986_013.jpg,1024,1024,nodule,590,301,753,477,,163,176
00016991_006.jpg,1024,1024,nodule,154,458,212,500,,58,42
00016991_006.jpg,1024,1024,nodule,751,431,835,495,,84,64
00017001_000.jpg,1024,1024,nodule,740,559,789,611,,49,52
00017001_000.jpg,1024,1024,nodule,273,598,329,647,,56,49
00017051_004.jpg,1024,1024,nodule,327,629,446,738,,119,109
00017051_004.jpg,1024,1024,nodule,675,434,730,483,,55,49
00017051_004.jpg,1024,1024,nodule,252,314,331,374,,79,60
00017051_004.jpg,1024,1024,nodule,319,300,393,368,,74,68
00017051_004.jpg,1024,1024,nodule,251,365,329,435,,78,70
00017051_004.jpg,1024,1024,nodule,693,375,771,439,,78,64
00017051_004.jpg,1024,1024,nodule,167,452,234,526,,67,74
00017051_004.jpg,1024,1024,nodule,221,438,299,507,,78,69
00017051_004.jpg,1024,1024,nodule,733,433,814,494,,81,61
00017051_004.jpg,1024,1024,nodule,231,476,312,541,,81,65
00017051_004.jpg,1024,1024,nodule,353,474,426,541,,73,67
00017051_004.jpg,1024,1024,nodule,586,475,660,546,,74,71
00017051_004.jpg,1024,1024,nodule,157,517,226,588,,69,71
00017051_004.jpg,1024,1024,nodule,623,545,696,615,,73,70
00017089_006.jpg,1024,1024,nodule,804,542,905,678,,101,136
00017089_006.jpg,1024,1024,nodule,842,738,918,815,,76,77
00017095_000.jpg,1024,1024,nodule,851,505,903,553,,52,48
00017098_007.jpg,1024,1024,nodule,290,377,344,426,,54,49
00017098_007.jpg,1024,1024,nodule,598,567,661,643,,63,76
00017098_011.jpg,1024,1024,nodule,292,296,380,350,,88,54
00017098_011.jpg,1024,1024,nodule,147,655,230,720,,83,65
00017179_000.jpg,1024,1024,nodule,675,339,782,445,,107,106
00017179_000.jpg,1024,1024,nodule,169,296,226,339,,57,43
00017179_000.jpg,1024,1024,nodule,91,473,147,521,,56,48
00017179_000.jpg,1024,1024,nodule,206,541,294,619,,88,78
00017262_000.jpg,1024,1024,nodule,688,757,777,831,,89,74
00017321_001.jpg,1024,1024,nodule,749,233,802,281,,53,48
00017324_008.jpg,1024,1024,nodule,379,142,454,216,,75,74
00017324_008.jpg,1024,1024,nodule,214,266,289,336,,75,70
00017395_000.jpg,1024,1024,nodule,696,538,820,643,,124,105
00017395_000.jpg,1024,1024,nodule,666,370,743,439,,77,69
00017395_000.jpg,1024,1024,nodule,559,646,651,715,,92,69
00017562_003.jpg,1024,1024,nodule,799,571,852,624,,53,53
00017562_003.jpg,1024,1024,nodule,701,297,770,368,,69,71
00017698_001.jpg,1024,1024,nodule,792,475,866,550,,74,75
00017747_031.jpg,1024,1024,nodule,825,282,905,360,,80,78
00017799_000.jpg,1024,1024,nodule,635,329,674,365,,39,36
00017881_006.jpg,1024,1024,nodule,421,322,444,347,,23,25
00018003_002.jpg,1024,1024,nodule,739,291,771,317,,32,26
00018102_001.jpg,1024,1024,nodule,811,250,929,352,,118,102
00018102_001.jpg,1024,1024,nodule,689,430,844,582,,155,152
00018102_001.jpg,1024,1024,nodule,754,381,812,426,,58,45
00018102_001.jpg,1024,1024,nodule,147,488,205,534,,58,46
00018102_001.jpg,1024,1024,nodule,769,585,827,632,,58,47
00018102_001.jpg,1024,1024,nodule,713,201,805,268,,92,67
00018102_001.jpg,1024,1024,nodule,273,245,358,308,,85,63
00018102_001.jpg,1024,1024,nodule,232,279,312,339,,80,60
00018102_001.jpg,1024,1024,nodule,351,259,432,326,,81,67
00018102_001.jpg,1024,1024,nodule,269,331,356,386,,87,55
00018102_001.jpg,1024,1024,nodule,186,346,266,403,,80,57
00018102_001.jpg,1024,1024,nodule,218,416,304,480,,86,64
00018102_001.jpg,1024,1024,nodule,292,389,421,465,,129,76
00018102_001.jpg,1024,1024,nodule,172,437,238,497,,66,60
00018102_001.jpg,1024,1024,nodule,284,444,354,510,,70,66
00018102_001.jpg,1024,1024,nodule,200,478,279,541,,79,63
00018102_001.jpg,1024,1024,nodule,890,486,959,554,,69,68
00018102_001.jpg,1024,1024,nodule,322,502,407,570,,85,68
00018102_001.jpg,1024,1024,nodule,692,555,774,630,,82,75
00018102_001.jpg,1024,1024,nodule,859,566,940,631,,81,65
00018102_001.jpg,1024,1024,nodule,871,605,950,666,,79,61
00018117_018.jpg,1024,1024,nodule,157,610,279,735,,122,125
00018171_000.jpg,1024,1024,nodule,546,515,721,678,,175,163
00018171_000.jpg,1024,1024,nodule,612,403,690,476,,78,73
00018171_000.jpg,1024,1024,nodule,170,640,252,713,,82,73
00018171_000.jpg,1024,1024,nodule,135,603,182,649,,47,46
00018307_001.jpg,1024,1024,nodule,294,489,410,595,,116,106
00018307_001.jpg,1024,1024,nodule,678,351,730,399,,52,48
00018307_001.jpg,1024,1024,nodule,720,364,770,413,,50,49
00018307_001.jpg,1024,1024,nodule,757,523,813,568,,56,45
00018307_001.jpg,1024,1024,nodule,724,563,807,629,,83,66
00018366_008.jpg,1024,1024,nodule,242,505,317,575,,75,70
00018366_008.jpg,1024,1024,nodule,204,592,279,663,,75,71
00018366_010.jpg,1024,1024,nodule,189,457,271,519,,82,62
00018366_010.jpg,1024,1024,nodule,128,537,215,597,,87,60
00018427_004.jpg,1024,1024,nodule,542,330,621,415,,79,85
00018443_008.jpg,1024,1024,nodule,310,569,371,649,,61,80
00018443_008.jpg,1024,1024,nodule,298,651,364,732,,66,81
00018472_001.jpg,1024,1024,nodule,649,638,726,716,,77,78
00018492_001.jpg,1024,1024,nodule,274,605,326,655,,52,50
00018519_000.jpg,1024,1024,nodule,737,568,789,618,,52,50
00018519_000.jpg,1024,1024,nodule,788,630,864,697,,76,67
00018592_008.jpg,1024,1024,nodule,276,576,345,659,,69,83
00018646_000.jpg,1024,1024,nodule,654,258,793,364,,139,106
00018646_000.jpg,1024,1024,nodule,826,529,879,577,,53,48
00018646_000.jpg,1024,1024,nodule,355,182,435,252,,80,70
00018765_003.jpg,1024,1024,nodule,312,199,390,266,,78,67
00018810_001.jpg,1024,1024,nodule,127,480,260,606,,133,126
00018853_001.jpg,1024,1024,nodule,836,457,894,502,,58,45
00018853_001.jpg,1024,1024,nodule,904,739,958,788,,54,49
00018853_001.jpg,1024,1024,nodule,705,336,793,392,,88,56
00018853_002.jpg,1024,1024,nodule,745,841,793,892,,48,51
00018853_002.jpg,1024,1024,nodule,593,361,673,436,,80,75
00018865_040.jpg,1024,1024,nodule,305,398,373,471,,68,73
00018958_002.jpg,1024,1024,nodule,600,511,679,591,,79,80
00018964_006.jpg,1024,1024,nodule,689,321,833,432,,144,111
00018964_006.jpg,1024,1024,nodule,609,442,741,553,,132,111
00018964_006.jpg,1024,1024,nodule,579,623,702,741,,123,118
00018964_006.jpg,1024,1024,nodule,141,356,202,401,,61,45
00018964_006.jpg,1024,1024,nodule,161,440,220,489,,59,49
00018964_006.jpg,1024,1024,nodule,815,519,871,562,,56,43
00018964_006.jpg,1024,1024,nodule,877,583,931,628,,54,45
00018964_006.jpg,1024,1024,nodule,134,281,210,343,,76,62
00018964_006.jpg,1024,1024,nodule,196,341,274,418,,78,77
00018964_006.jpg,1024,1024,nodule,199,432,282,496,,83,64
00018964_006.jpg,1024,1024,nodule,794,425,870,490,,76,65
00018964_006.jpg,1024,1024,nodule,196,473,277,542,,81,69
00018964_006.jpg,1024,1024,nodule,754,474,832,544,,78,70
00018964_006.jpg,1024,1024,nodule,47,568,125,631,,78,63
00018964_006.jpg,1024,1024,nodule,192,556,268,617,,76,61
00018964_006.jpg,1024,1024,nodule,262,554,341,631,,79,77
00018964_006.jpg,1024,1024,nodule,793,585,869,654,,76,69
00018964_006.jpg,1024,1024,nodule,670,670,752,734,,82,64
00018964_006.jpg,1024,1024,nodule,877,698,958,768,,81,70
00018964_008.jpg,1024,1024,nodule,685,415,815,527,,130,112
00018964_008.jpg,1024,1024,nodule,635,533,738,648,,103,115
00018964_008.jpg,1024,1024,nodule,579,735,702,867,,123,132
00018964_008.jpg,1024,1024,nodule,741,260,795,310,,54,50
00018964_008.jpg,1024,1024,nodule,218,376,267,427,,49,51
00018964_008.jpg,1024,1024,nodule,233,614,280,666,,47,52
00018964_008.jpg,1024,1024,nodule,728,599,782,650,,54,51
00018964_008.jpg,1024,1024,nodule,134,686,186,737,,52,51
00018964_008.jpg,1024,1024,nodule,855,685,907,731,,52,46
00018964_008.jpg,1024,1024,nodule,258,422,332,505,,74,83
00018964_008.jpg,1024,1024,nodule,325,467,394,551,,69,84
00018964_008.jpg,1024,1024,nodule,264,514,341,579,,77,65
00018964_008.jpg,1024,1024,nodule,202,549,268,621,,66,72
00018964_008.jpg,1024,1024,nodule,342,557,415,634,,73,77
00018964_008.jpg,1024,1024,nodule,758,569,838,638,,80,69
00018964_008.jpg,1024,1024,nodule,646,695,717,765,,71,70
00018964_008.jpg,1024,1024,nodule,773,690,858,758,,85,68
00018964_008.jpg,1024,1024,nodule,227,715,300,796,,73,81
00018964_008.jpg,1024,1024,nodule,688,774,766,842,,78,68
00018964_008.jpg,1024,1024,nodule,842,797,917,867,,75,70
00019006_001.jpg,1024,1024,nodule,153,449,295,597,,142,148
00019006_001.jpg,1024,1024,nodule,247,644,322,722,,75,78
00019013_003.jpg,1024,1024,nodule,599,247,685,307,,86,60
00019013_003.jpg,1024,1024,nodule,349,315,424,393,,75,78
00019013_003.jpg,1024,1024,nodule,308,377,383,456,,75,79
00019013_003.jpg,1024,1024,nodule,717,400,801,461,,84,61
00019013_003.jpg,1024,1024,nodule,779,557,868,620,,89,63
00019043_000.jpg,1024,1024,nodule,196,643,246,692,,50,49
00019071_000.jpg,1024,1024,nodule,646,602,754,721,,108,119
00019071_000.jpg,1024,1024,nodule,798,602,851,650,,53,48
00019071_000.jpg,1024,1024,nodule,747,509,824,576,,77,67
00019124_048.jpg,1024,1024,nodule,617,540,716,655,,99,115
00019124_049.jpg,1024,1024,nodule,676,490,790,601,,114,111
00019124_049.jpg,1024,1024,nodule,711,305,781,378,,70,73
00019124_061.jpg,1024,1024,nodule,629,658,731,771,,102,113
00019124_061.jpg,1024,1024,nodule,670,451,741,527,,71,76
00019124_062.jpg,1024,1024,nodule,589,670,686,794,,97,124
00019124_062.jpg,1024,1024,nodule,639,441,703,526,,64,85
00019124_065.jpg,1024,1024,nodule,672,580,775,690,,103,110
00019124_065.jpg,1024,1024,nodule,698,389,765,466,,67,77
00019124_084.jpg,1024,1024,nodule,282,550,412,708,,130,158
00019124_084.jpg,1024,1024,nodule,679,498,746,578,,67,80
00019124_084.jpg,1024,1024,nodule,705,631,781,704,,76,73
00019124_084.jpg,1024,1024,nodule,600,704,674,786,,74,82
00019124_084.jpg,1024,1024,nodule,708,704,792,785,,84,81
00019124_084.jpg,1024,1024,nodule,747,775,822,857,,75,82
00019124_087.jpg,1024,1024,nodule,616,458,691,542,,75,84
00019124_087.jpg,1024,1024,nodule,642,555,716,625,,74,70
00019124_087.jpg,1024,1024,nodule,556,650,634,733,,78,83
00019124_087.jpg,1024,1024,nodule,633,648,709,716,,76,68
00019124_087.jpg,1024,1024,nodule,678,623,748,701,,70,78
00019124_087.jpg,1024,1024,nodule,730,682,802,757,,72,75
00019124_087.jpg,1024,1024,nodule,668,706,736,784,,68,78
00019124_087.jpg,1024,1024,nodule,718,751,800,822,,82,71
00019124_087.jpg,1024,1024,nodule,229,484,354,650,,125,166
00019124_090.jpg,1024,1024,nodule,245,483,357,603,,112,120
00019124_090.jpg,1024,1024,nodule,648,389,717,461,,69,72
00019124_090.jpg,1024,1024,nodule,679,425,752,495,,73,70
00019124_090.jpg,1024,1024,nodule,663,494,750,567,,87,73
00019124_090.jpg,1024,1024,nodule,708,565,790,638,,82,73
00019124_090.jpg,1024,1024,nodule,611,596,690,677,,79,81
00019124_090.jpg,1024,1024,nodule,764,609,836,693,,72,84
00019124_090.jpg,1024,1024,nodule,691,639,761,705,,70,66
00019124_090.jpg,1024,1024,nodule,775,679,848,746,,73,67
00019124_102.jpg,1024,1024,nodule,663,439,737,514,,74,75
00019124_102.jpg,1024,1024,nodule,696,476,765,540,,69,64
00019124_102.jpg,1024,1024,nodule,679,543,761,614,,82,71
00019124_102.jpg,1024,1024,nodule,725,614,801,689,,76,75
00019124_102.jpg,1024,1024,nodule,610,645,690,721,,80,76
00019124_102.jpg,1024,1024,nodule,710,688,785,757,,75,69
00019124_102.jpg,1024,1024,nodule,779,670,852,744,,73,74
00019124_102.jpg,1024,1024,nodule,586,719,666,784,,80,65
00019124_102.jpg,1024,1024,nodule,765,749,846,823,,81,74
00019279_000.jpg,1024,1024,nodule,169,657,249,731,,80,74
00019279_000.jpg,1024,1024,nodule,759,688,838,753,,79,65
00019371_000.jpg,1024,1024,nodule,193,394,228,433,,35,39
00019373_006.jpg,1024,1024,nodule,337,449,450,582,,113,133
00019373_006.jpg,1024,1024,nodule,251,648,360,753,,109,105
00019373_006.jpg,1024,1024,nodule,307,407,387,488,,80,81
00019373_022.jpg,1024,1024,nodule,360,384,493,501,,133,117
00019373_022.jpg,1024,1024,nodule,148,443,401,660,,253,217
00019373_033.jpg,1024,1024,nodule,223,410,392,602,,169,192
00019373_033.jpg,1024,1024,nodule,128,585,263,711,,135,126
00019373_051.jpg,1024,1024,nodule,239,582,343,683,,104,101
00019373_051.jpg,1024,1024,nodule,57,662,154,773,,97,111
00019373_051.jpg,1024,1024,nodule,525,650,644,771,,119,121
00019373_051.jpg,1024,1024,nodule,631,226,703,296,,72,70
00019373_051.jpg,1024,1024,nodule,217,435,289,500,,72,65
00019373_051.jpg,1024,1024,nodule,729,412,806,486,,77,74
00019373_051.jpg,1024,1024,nodule,202,534,270,601,,68,67
00019373_051.jpg,1024,1024,nodule,833,572,904,647,,71,75
00019373_051.jpg,1024,1024,nodule,737,693,816,764,,79,71
00019373_051.jpg,1024,1024,nodule,830,682,909,761,,79,79
00019373_056.jpg,1024,1024,nodule,766,408,871,520,,105,112
00019373_056.jpg,1024,1024,nodule,262,631,373,742,,111,111
00019373_056.jpg,1024,1024,nodule,295,300,376,383,,81,83
00019373_056.jpg,1024,1024,nodule,226,397,300,472,,74,75
00019373_056.jpg,1024,1024,nodule,337,399,426,484,,89,85
00019373_056.jpg,1024,1024,nodule,324,474,408,555,,84,81
00019373_056.jpg,1024,1024,nodule,265,554,339,618,,74,64
00019373_056.jpg,1024,1024,nodule,759,780,841,854,,82,74
00019373_056.jpg,1024,1024,nodule,868,769,946,851,,78,82
00019373_058.jpg,1024,1024,nodule,330,331,451,478,,121,147
00019373_058.jpg,1024,1024,nodule,758,374,859,487,,101,113
00019373_058.jpg,1024,1024,nodule,240,578,360,688,,120,110
00019373_058.jpg,1024,1024,nodule,835,715,938,826,,103,111
00019373_058.jpg,1024,1024,nodule,254,330,329,401,,75,71
00019373_058.jpg,1024,1024,nodule,764,747,846,820,,82,73
00019593_000.jpg,1024,1024,nodule,823,561,874,611,,51,50
00019624_002.jpg,1024,1024,nodule,609,222,686,291,,77,69
00019624_002.jpg,1024,1024,nodule,314,568,388,641,,74,73
00019624_002.jpg,1024,1024,nodule,366,695,437,772,,71,77
00019624_002.jpg,1024,1024,nodule,304,379,390,467,,86,88
00019634_003.jpg,1024,1024,nodule,758,290,875,422,,117,132
00019634_003.jpg,1024,1024,nodule,643,373,828,518,,185,145
00019634_003.jpg,1024,1024,nodule,142,492,236,580,,94,88
00019634_003.jpg,1024,1024,nodule,198,564,315,681,,117,117
00019634_003.jpg,1024,1024,nodule,632,569,832,726,,200,157
00019634_003.jpg,1024,1024,nodule,103,634,199,741,,96,107
00019634_003.jpg,1024,1024,nodule,408,113,458,164,,50,51
00019634_003.jpg,1024,1024,nodule,655,199,726,273,,71,74
00019634_003.jpg,1024,1024,nodule,623,267,695,347,,72,80
00019634_003.jpg,1024,1024,nodule,235,306,310,386,,75,80
00019634_003.jpg,1024,1024,nodule,667,297,740,376,,73,79
00019634_003.jpg,1024,1024,nodule,732,305,797,384,,65,79
00019634_003.jpg,1024,1024,nodule,567,105,625,181,,58,76
00019634_003.jpg,1024,1024,nodule,192,434,272,514,,80,80
00019634_003.jpg,1024,1024,nodule,218,411,296,500,,78,89
00019634_003.jpg,1024,1024,nodule,191,519,263,594,,72,75
00019634_003.jpg,1024,1024,nodule,203,689,278,772,,75,83
00019634_004.jpg,1024,1024,nodule,751,374,865,498,,114,124
00019634_004.jpg,1024,1024,nodule,219,496,323,624,,104,128
00019634_004.jpg,1024,1024,nodule,702,507,828,669,,126,162
00019634_004.jpg,1024,1024,nodule,694,245,768,325,,74,80
00019634_009.jpg,1024,1024,nodule,713,379,826,536,,113,157
00019634_009.jpg,1024,1024,nodule,633,470,795,648,,162,178
00019634_009.jpg,1024,1024,nodule,292,557,410,693,,118,136
00019634_009.jpg,1024,1024,nodule,140,610,258,722,,118,112
00019730_018.jpg,1024,1024,nodule,241,579,297,623,,56,44
00019739_000.jpg,1024,1024,nodule,604,384,730,480,,126,96
00019739_000.jpg,1024,1024,nodule,764,573,898,688,,134,115
00019739_000.jpg,1024,1024,nodule,779,390,873,456,,94,66
00019805_001.jpg,1024,1024,nodule,277,503,402,623,,125,120
00019805_001.jpg,1024,1024,nodule,738,611,788,661,,50,50
00019805_001.jpg,1024,1024,nodule,352,439,437,519,,85,80
00019805_001.jpg,1024,1024,nodule,139,616,223,688,,84,72
00019805_001.jpg,1024,1024,nodule,671,585,743,659,,72,74
00020009_000.jpg,1024,1024,nodule,788,678,837,729,,49,51
00020009_000.jpg,1024,1024,nodule,577,528,646,613,,69,85
00020047_002.jpg,1024,1024,nodule,250,543,342,658,,92,115
00020047_002.jpg,1024,1024,nodule,731,293,779,349,,48,56
00020047_002.jpg,1024,1024,nodule,247,387,299,441,,52,54
00020047_002.jpg,1024,1024,nodule,831,756,880,807,,49,51
00020047_002.jpg,1024,1024,nodule,741,104,807,181,,66,77
00020047_002.jpg,1024,1024,nodule,714,195,781,281,,67,86
00020047_002.jpg,1024,1024,nodule,782,269,852,361,,70,92
00020047_002.jpg,1024,1024,nodule,756,366,819,444,,63,78
00020047_002.jpg,1024,1024,nodule,200,424,274,496,,74,72
00020047_002.jpg,1024,1024,nodule,778,488,852,557,,74,69
00020047_002.jpg,1024,1024,nodule,188,503,271,572,,83,69
00020047_002.jpg,1024,1024,nodule,756,574,829,648,,73,74
00020070_007.jpg,1024,1024,nodule,807,606,863,653,,56,47
00020070_007.jpg,1024,1024,nodule,695,558,775,631,,80,73
00020070_007.jpg,1024,1024,nodule,181,586,263,649,,82,63
00020095_001.jpg,1024,1024,nodule,163,713,210,768,,47,55
00020156_007.jpg,1024,1024,nodule,169,555,217,610,,48,55
00020156_007.jpg,1024,1024,nodule,120,649,170,703,,50,54
00020156_007.jpg,1024,1024,nodule,193,304,263,378,,70,74
00020158_004.jpg,1024,1024,nodule,226,488,278,536,,52,48
00020195_002.jpg,1024,1024,nodule,766,420,817,472,,51,52
00020195_002.jpg,1024,1024,nodule,678,454,757,524,,79,70
00020195_002.jpg,1024,1024,nodule,675,531,758,603,,83,72
00020195_002.jpg,1024,1024,nodule,722,502,801,580,,79,78
00020195_002.jpg,1024,1024,nodule,524,653,588,732,,64,79
00020195_002.jpg,1024,1024,nodule,729,686,795,759,,66,73
00020195_002.jpg,1024,1024,nodule,672,730,749,804,,77,74
00020298_000.jpg,1024,1024,nodule,255,295,323,373,,68,78
00020298_000.jpg,1024,1024,nodule,750,658,820,728,,70,70
00020329_002.jpg,1024,1024,nodule,771,354,841,423,,70,69
00020333_003.jpg,1024,1024,nodule,413,321,528,437,,115,116
00020333_003.jpg,1024,1024,nodule,331,505,461,663,,130,158
00020373_003.jpg,1024,1024,nodule,268,376,426,511,,158,135
00020373_003.jpg,1024,1024,nodule,295,233,350,276,,55,43
00020373_003.jpg,1024,1024,nodule,333,301,409,371,,76,70
00020373_003.jpg,1024,1024,nodule,136,455,212,519,,76,64
00020393_003.jpg,1024,1024,nodule,620,124,713,237,,93,113
00020393_003.jpg,1024,1024,nodule,301,239,348,296,,47,57
00020393_003.jpg,1024,1024,nodule,307,312,359,365,,52,53
00020393_003.jpg,1024,1024,nodule,712,108,778,178,,66,70
00020393_003.jpg,1024,1024,nodule,343,164,412,239,,69,75
00020393_003.jpg,1024,1024,nodule,298,183,354,257,,56,74
00020393_003.jpg,1024,1024,nodule,701,170,759,250,,58,80
00020393_003.jpg,1024,1024,nodule,685,274,757,350,,72,76
00020393_003.jpg,1024,1024,nodule,668,307,745,377,,77,70
00020393_003.jpg,1024,1024,nodule,809,380,874,452,,65,72
00020393_003.jpg,1024,1024,nodule,266,494,334,564,,68,70
00020393_005.jpg,1024,1024,nodule,728,269,779,319,,51,50
00020393_005.jpg,1024,1024,nodule,267,315,329,368,,62,53
00020393_005.jpg,1024,1024,nodule,238,374,290,419,,52,45
00020393_005.jpg,1024,1024,nodule,561,367,616,414,,55,47
00020393_005.jpg,1024,1024,nodule,296,387,346,440,,50,53
00020393_005.jpg,1024,1024,nodule,768,408,817,458,,49,50
00020393_005.jpg,1024,1024,nodule,644,185,721,252,,77,67
00020393_005.jpg,1024,1024,nodule,237,247,312,313,,75,66
00020393_005.jpg,1024,1024,nodule,259,223,344,292,,85,69
00020393_005.jpg,1024,1024,nodule,564,219,642,300,,78,81
00020393_005.jpg,1024,1024,nodule,632,238,701,307,,69,69
00020393_005.jpg,1024,1024,nodule,600,321,688,398,,88,77
00020393_005.jpg,1024,1024,nodule,258,550,335,625,,77,75
00020393_005.jpg,1024,1024,nodule,322,590,402,663,,80,73
00020393_005.jpg,1024,1024,nodule,666,616,737,683,,71,67
00020393_005.jpg,1024,1024,nodule,73,670,140,746,,67,76
00020398_033.jpg,1024,1024,nodule,811,487,879,562,,68,75
00020398_034.jpg,1024,1024,nodule,254,500,370,602,,116,102
00020398_034.jpg,1024,1024,nodule,744,515,819,609,,75,94
00020405_007.jpg,1024,1024,nodule,760,428,858,537,,98,109
00020405_007.jpg,1024,1024,nodule,726,577,783,626,,57,49
00020405_007.jpg,1024,1024,nodule,749,363,827,436,,78,73
00020408_028.jpg,1024,1024,nodule,230,317,300,392,,70,75
00020408_042.jpg,1024,1024,nodule,162,246,238,317,,76,71
00020408_042.jpg,1024,1024,nodule,203,594,271,667,,68,73
00020436_004.jpg,1024,1024,nodule,764,498,816,547,,52,49
00020436_004.jpg,1024,1024,nodule,240,493,322,559,,82,66
00020436_004.jpg,1024,1024,nodule,604,634,687,712,,83,78
00020539_000.jpg,1024,1024,nodule,317,266,373,317,,56,51
00020539_000.jpg,1024,1024,nodule,852,441,905,490,,53,49
00020539_000.jpg,1024,1024,nodule,238,318,310,388,,72,70
00020539_000.jpg,1024,1024,nodule,719,536,792,605,,73,69
00020539_000.jpg,1024,1024,nodule,803,584,887,664,,84,80
00020539_000.jpg,1024,1024,nodule,580,627,661,704,,81,77
00020539_001.jpg,1024,1024,nodule,822,612,922,719,,100,107
00020539_001.jpg,1024,1024,nodule,885,458,934,513,,49,55
00020539_001.jpg,1024,1024,nodule,230,658,276,718,,46,60
00020539_001.jpg,1024,1024,nodule,338,217,406,292,,68,75
00020539_001.jpg,1024,1024,nodule,266,290,328,362,,62,72
00020539_001.jpg,1024,1024,nodule,749,549,820,628,,71,79
00020539_001.jpg,1024,1024,nodule,318,714,398,788,,80,74
00020624_003.jpg,1024,1024,nodule,226,561,278,610,,52,49
00020631_003.jpg,1024,1024,nodule,809,545,882,614,,73,69
00020680_002.jpg,1024,1024,nodule,280,239,338,283,,58,44
00020680_002.jpg,1024,1024,nodule,134,497,187,545,,53,48
00020680_002.jpg,1024,1024,nodule,116,531,168,581,,52,50
00020680_002.jpg,1024,1024,nodule,738,341,811,412,,73,71
00020680_002.jpg,1024,1024,nodule,93,660,170,724,,77,64
00020680_002.jpg,1024,1024,nodule,149,635,224,696,,75,61
00020680_002.jpg,1024,1024,nodule,282,733,359,817,,77,84
00020680_005.jpg,1024,1024,nodule,264,668,372,772,,108,104
00020680_005.jpg,1024,1024,nodule,280,204,337,247,,57,43
00020680_005.jpg,1024,1024,nodule,205,231,263,274,,58,43
00020680_005.jpg,1024,1024,nodule,676,229,730,275,,54,46
00020680_005.jpg,1024,1024,nodule,114,475,168,523,,54,48
00020680_005.jpg,1024,1024,nodule,87,514,136,562,,49,48
00020680_005.jpg,1024,1024,nodule,778,320,850,391,,72,71
00020680_005.jpg,1024,1024,nodule,132,580,217,643,,85,63
00020680_005.jpg,1024,1024,nodule,66,615,147,679,,81,64
00020680_007.jpg,1024,1024,nodule,308,237,360,282,,52,45
00020680_007.jpg,1024,1024,nodule,644,260,699,307,,55,47
00020680_007.jpg,1024,1024,nodule,735,350,800,429,,65,79
00020680_007.jpg,1024,1024,nodule,685,428,755,507,,70,79
00020680_007.jpg,1024,1024,nodule,657,484,723,554,,66,70
00020680_007.jpg,1024,1024,nodule,124,656,196,732,,72,76
00020680_007.jpg,1024,1024,nodule,183,630,254,696,,71,66
00020680_007.jpg,1024,1024,nodule,302,728,379,811,,77,83
00020680_007.jpg,1024,1024,nodule,243,328,272,356,,29,28
00020703_002.jpg,1024,1024,nodule,681,404,764,477,,83,73
00020703_002.jpg,1024,1024,nodule,108,496,193,565,,85,69
00020703_002.jpg,1024,1024,nodule,568,479,656,547,,88,68
00020703_010.jpg,1024,1024,nodule,701,444,829,605,,128,161
00020703_012.jpg,1024,1024,nodule,695,394,862,570,,167,176
00020703_012.jpg,1024,1024,nodule,149,440,219,513,,70,73
00020703_014.jpg,1024,1024,nodule,740,428,878,575,,138,147
00020703_014.jpg,1024,1024,nodule,806,615,884,687,,78,72
00020703_014.jpg,1024,1024,nodule,208,635,280,707,,72,72
00020703_032.jpg,1024,1024,nodule,715,402,865,528,,150,126
00020716_001.jpg,1024,1024,nodule,746,349,799,396,,53,47
00020716_006.jpg,1024,1024,nodule,741,323,791,373,,50,50
00020735_000.jpg,1024,1024,nodule,230,382,302,455,,72,73
00020774_000.jpg,1024,1024,nodule,228,471,299,544,,71,73
00020822_001.jpg,1024,1024,nodule,824,300,857,341,,33,41
00020822_001.jpg,1024,1024,nodule,324,215,370,271,,46,56
00020822_001.jpg,1024,1024,nodule,759,198,806,251,,47,53
00020822_001.jpg,1024,1024,nodule,749,266,795,323,,46,57
00020822_001.jpg,1024,1024,nodule,322,456,372,509,,50,53
00020822_001.jpg,1024,1024,nodule,235,568,286,622,,51,54
00020822_001.jpg,1024,1024,nodule,270,194,339,262,,69,68
00020822_001.jpg,1024,1024,nodule,265,300,334,373,,69,73
00020822_001.jpg,1024,1024,nodule,739,306,800,381,,61,75
00020822_001.jpg,1024,1024,nodule,308,359,377,427,,69,68
00020822_001.jpg,1024,1024,nodule,659,359,722,436,,63,77
00020822_001.jpg,1024,1024,nodule,766,346,830,422,,64,76
00020822_001.jpg,1024,1024,nodule,729,459,793,534,,64,75
00020921_001.jpg,1024,1024,nodule,635,181,737,298,,102,117
00020921_001.jpg,1024,1024,nodule,175,431,290,544,,115,113
00020967_020.jpg,1024,1024,nodule,805,400,871,482,,66,82
00020967_020.jpg,1024,1024,nodule,574,636,639,722,,65,86
00020967_020.jpg,1024,1024,nodule,779,397,821,451,,42,54
00020974_000.jpg,1024,1024,nodule,223,574,327,681,,104,107
00020974_000.jpg,1024,1024,nodule,680,556,756,633,,76,77
00020974_000.jpg,1024,1024,nodule,771,701,853,766,,82,65
00020974_000.jpg,1024,1024,nodule,802,750,883,821,,81,71
00021086_007.jpg,1024,1024,nodule,101,536,153,584,,52,48
00021086_007.jpg,1024,1024,nodule,87,583,140,631,,53,48
00021112_000.jpg,1024,1024,nodule,227,469,313,536,,86,67
00021130_001.jpg,1024,1024,nodule,288,590,356,671,,68,81
00021166_000.jpg,1024,1024,nodule,733,313,784,364,,51,51
00021166_000.jpg,1024,1024,nodule,724,379,770,431,,46,52
00021166_000.jpg,1024,1024,nodule,675,454,724,509,,49,55
00021166_000.jpg,1024,1024,nodule,763,457,815,508,,52,51
00021166_000.jpg,1024,1024,nodule,250,470,298,523,,48,53
00021166_000.jpg,1024,1024,nodule,293,471,340,520,,47,49
00021166_000.jpg,1024,1024,nodule,707,524,756,577,,49,53
00021166_000.jpg,1024,1024,nodule,315,572,364,623,,49,51
00021166_000.jpg,1024,1024,nodule,739,567,789,616,,50,49
00021166_000.jpg,1024,1024,nodule,268,593,313,648,,45,55
00021166_000.jpg,1024,1024,nodule,423,593,473,645,,50,52
00021166_000.jpg,1024,1024,nodule,640,597,692,646,,52,49
00021166_000.jpg,1024,1024,nodule,707,623,756,673,,49,50
00021166_000.jpg,1024,1024,nodule,763,607,813,656,,50,49
00021166_000.jpg,1024,1024,nodule,607,656,658,707,,51,51
00021166_000.jpg,1024,1024,nodule,699,745,755,792,,56,47
00021166_000.jpg,1024,1024,nodule,327,377,394,446,,67,69
00021166_000.jpg,1024,1024,nodule,731,476,801,552,,70,76
00021166_000.jpg,1024,1024,nodule,776,678,850,751,,74,73
00021201_105.jpg,1024,1024,nodule,680,368,730,416,,50,48
00021212_006.jpg,1024,1024,nodule,313,615,365,668,,52,53
00021212_006.jpg,1024,1024,nodule,381,567,450,639,,69,72
00021289_000.jpg,1024,1024,nodule,576,340,675,451,,99,111
00021289_000.jpg,1024,1024,nodule,694,447,783,521,,89,74
00021374_000.jpg,1024,1024,nodule,752,366,871,484,,119,118
00021377_000.jpg,1024,1024,nodule,247,375,437,555,,190,180
00021377_000.jpg,1024,1024,nodule,34,686,108,755,,74,69
00021403_001.jpg,1024,1024,nodule,624,616,695,685,,71,69
00021403_002.jpg,1024,1024,nodule,207,454,262,504,,55,50
00021403_002.jpg,1024,1024,nodule,656,548,729,619,,73,71
00021473_000.jpg,1024,1024,nodule,298,735,409,841,,111,106
00021494_006.jpg,1024,1024,nodule,850,234,886,272,,36,38
00021494_006.jpg,1024,1024,nodule,821,453,880,496,,59,43
00021494_006.jpg,1024,1024,nodule,709,600,793,664,,84,64
00021494_007.jpg,1024,1024,nodule,710,203,745,240,,35,37
00021494_007.jpg,1024,1024,nodule,704,417,754,467,,50,50
00021494_007.jpg,1024,1024,nodule,706,607,784,674,,78,67
00021495_005.jpg,1024,1024,nodule,234,593,282,648,,48,55
00021609_004.jpg,1024,1024,nodule,426,285,480,334,,54,49
00021708_001.jpg,1024,1024,nodule,338,288,411,353,,73,65
00021817_005.jpg,1024,1024,nodule,317,501,438,610,,121,109
00022113_002.jpg,1024,1024,nodule,296,550,365,631,,69,81
00022119_000.jpg,1024,1024,nodule,358,476,423,549,,65,73
00022132_003.jpg,1024,1024,nodule,703,686,777,753,,74,67
00022179_000.jpg,1024,1024,nodule,184,488,323,604,,139,116
00022238_000.jpg,1024,1024,nodule,855,557,912,603,,57,46
00022238_000.jpg,1024,1024,nodule,171,719,229,765,,58,46
00022238_000.jpg,1024,1024,nodule,194,763,252,810,,58,47
00022263_005.jpg,1024,1024,nodule,214,293,315,404,,101,111
00022263_005.jpg,1024,1024,nodule,789,583,914,687,,125,104
00022263_005.jpg,1024,1024,nodule,336,200,387,248,,51,48
00022263_005.jpg,1024,1024,nodule,831,516,904,582,,73,66
00022363_000.jpg,1024,1024,nodule,845,547,898,594,,53,47
00022374_000.jpg,1024,1024,nodule,186,433,299,533,,113,100
00022374_000.jpg,1024,1024,nodule,746,200,817,264,,71,64
00022520_003.jpg,1024,1024,nodule,725,297,774,350,,49,53
00022586_000.jpg,1024,1024,nodule,173,592,252,676,,79,84
00022591_000.jpg,1024,1024,nodule,210,497,244,536,,34,39
00022684_001.jpg,1024,1024,nodule,741,536,837,655,,96,119
00022684_001.jpg,1024,1024,nodule,762,725,810,780,,48,55
00022684_004.jpg,1024,1024,nodule,707,582,773,656,,66,74
00022726_006.jpg,1024,1024,nodule,683,353,822,477,,139,124
00022726_006.jpg,1024,1024,nodule,363,387,449,459,,86,72
00022726_006.jpg,1024,1024,nodule,762,628,851,703,,89,75
00022726_011.jpg,1024,1024,nodule,372,386,475,487,,103,101
00022726_011.jpg,1024,1024,nodule,672,359,788,489,,116,130
00022726_011.jpg,1024,1024,nodule,323,591,460,704,,137,113
00022726_011.jpg,1024,1024,nodule,656,252,745,329,,89,77
00022726_011.jpg,1024,1024,nodule,770,473,837,550,,67,77
00022726_011.jpg,1024,1024,nodule,680,653,759,734,,79,81
00022726_011.jpg,1024,1024,nodule,754,653,830,735,,76,82
00022726_011.jpg,1024,1024,nodule,220,758,309,823,,89,65
00022837_025.jpg,1024,1024,nodule,749,368,907,512,,158,144
00022837_025.jpg,1024,1024,nodule,896,651,1019,767,,123,116
00022973_000.jpg,1024,1024,nodule,308,490,360,541,,52,51
00022977_007.jpg,1024,1024,nodule,702,640,749,695,,47,55
00022977_007.jpg,1024,1024,nodule,553,486,621,561,,68,75
00022977_007.jpg,1024,1024,nodule,304,498,362,578,,58,80
00022977_007.jpg,1024,1024,nodule,247,645,311,719,,64,74
00023018_000.jpg,1024,1024,nodule,700,513,770,589,,70,76
00023033_000.jpg,1024,1024,nodule,282,170,339,221,,57,51
00023033_000.jpg,1024,1024,nodule,324,119,400,193,,76,74
00023033_000.jpg,1024,1024,nodule,711,725,785,796,,74,71
00023033_001.jpg,1024,1024,nodule,282,235,337,286,,55,51
00023033_001.jpg,1024,1024,nodule,315,170,388,250,,73,80
00023033_001.jpg,1024,1024,nodule,760,723,833,792,,73,69
00023033_002.jpg,1024,1024,nodule,798,851,847,906,,49,55
00023033_002.jpg,1024,1024,nodule,306,243,385,321,,79,78
00023033_002.jpg,1024,1024,nodule,264,300,332,374,,68,74
00023033_007.jpg,1024,1024,nodule,284,106,358,185,,74,79
00023033_007.jpg,1024,1024,nodule,240,165,307,237,,67,72
00023033_012.jpg,1024,1024,nodule,737,722,785,775,,48,53
00023033_012.jpg,1024,1024,nodule,283,137,356,216,,73,79
00023033_012.jpg,1024,1024,nodule,242,190,306,264,,64,74
00023078_000.jpg,1024,1024,nodule,744,679,793,728,,49,49
00023140_004.jpg,1024,1024,nodule,747,411,829,485,,82,74
00023140_004.jpg,1024,1024,nodule,296,529,379,606,,83,77
00023140_004.jpg,1024,1024,nodule,587,600,662,672,,75,72
00023162_023.jpg,1024,1024,nodule,727,479,780,528,,53,49
00023162_023.jpg,1024,1024,nodule,802,473,857,522,,55,49
00023162_023.jpg,1024,1024,nodule,782,359,848,429,,66,70
00023162_023.jpg,1024,1024,nodule,488,511,562,583,,74,72
00023310_002.jpg,1024,1024,nodule,615,571,664,624,,49,53
00023313_010.jpg,1024,1024,nodule,736,462,883,632,,147,170
00024523_000.jpg,1024,1024,nodule,329,282,363,309,,34,27
00025128_000.jpg,1024,1024,nodule,251,501,285,538,,34,37
00025128_000.jpg,1024,1024,nodule,282,175,332,221,,50,46
00025128_000.jpg,1024,1024,nodule,728,395,780,447,,52,52
00025128_000.jpg,1024,1024,nodule,190,510,241,562,,51,52
00025128_000.jpg,1024,1024,nodule,228,739,282,789,,54,50
00025128_000.jpg,1024,1024,nodule,264,298,333,368,,69,70
00025128_000.jpg,1024,1024,nodule,307,305,380,381,,73,76
00025128_000.jpg,1024,1024,nodule,209,367,280,433,,71,66
00025128_000.jpg,1024,1024,nodule,686,545,765,625,,79,80
00025128_000.jpg,1024,1024,nodule,800,548,874,618,,74,70
00025128_000.jpg,1024,1024,nodule,264,613,339,689,,75,76
00025128_000.jpg,1024,1024,nodule,155,644,236,715,,81,71
00025128_000.jpg,1024,1024,nodule,152,682,222,750,,70,68
00025128_000.jpg,1024,1024,nodule,178,732,260,793,,82,61
00025128_000.jpg,1024,1024,nodule,633,781,709,849,,76,68
00025128_000.jpg,1024,1024,nodule,854,744,925,825,,71,81
00025128_000.jpg,1024,1024,nodule,262,789,339,858,,77,69
00025181_016.jpg,1024,1024,nodule,659,498,802,622,,143,124
00025181_016.jpg,1024,1024,nodule,688,470,778,531,,90,61
00025181_016.jpg,1024,1024,nodule,897,610,979,684,,82,74
00025181_016.jpg,1024,1024,nodule,312,686,399,748,,87,62
00025332_000.jpg,1024,1024,nodule,258,509,289,538,,31,29
00025341_000.jpg,1024,1024,nodule,880,611,926,665,,46,54
00025342_007.jpg,1024,1024,nodule,225,502,337,615,,112,113
00025368_003.jpg,1024,1024,nodule,725,451,798,539,,73,88
00025368_003.jpg,1024,1024,nodule,673,550,747,623,,74,73
00025368_012.jpg,1024,1024,nodule,361,441,485,584,,124,143
00025368_012.jpg,1024,1024,nodule,743,456,861,552,,118,96
00025368_012.jpg,1024,1024,nodule,344,645,452,765,,108,120
00025368_012.jpg,1024,1024,nodule,839,707,894,754,,55,47
00025448_001.jpg,1024,1024,nodule,305,742,336,783,,31,41
00025457_002.jpg,1024,1024,nodule,196,475,305,574,,109,99
00025505_000.jpg,1024,1024,nodule,584,313,694,418,,110,105
00025505_000.jpg,1024,1024,nodule,756,227,809,279,,53,52
00025505_000.jpg,1024,1024,nodule,735,280,787,328,,52,48
00025505_000.jpg,1024,1024,nodule,165,314,215,363,,50,49
00025505_000.jpg,1024,1024,nodule,770,326,820,377,,50,51
00025505_000.jpg,1024,1024,nodule,698,367,753,418,,55,51
00025505_000.jpg,1024,1024,nodule,625,418,677,469,,52,51
00025505_000.jpg,1024,1024,nodule,194,441,249,491,,55,50
00025505_000.jpg,1024,1024,nodule,786,462,837,511,,51,49
00025505_000.jpg,1024,1024,nodule,730,498,782,547,,52,49
00025505_000.jpg,1024,1024,nodule,156,544,209,590,,53,46
00025505_000.jpg,1024,1024,nodule,798,536,849,588,,51,52
00025505_000.jpg,1024,1024,nodule,823,575,873,627,,50,52
00025505_000.jpg,1024,1024,nodule,293,206,372,282,,79,76
00025542_002.jpg,1024,1024,nodule,309,447,393,519,,84,72
00025628_000.jpg,1024,1024,nodule,310,462,376,537,,66,75
00025670_000.jpg,1024,1024,nodule,632,577,749,684,,117,107
00025671_000.jpg,1024,1024,nodule,603,278,727,395,,124,117
00025671_000.jpg,1024,1024,nodule,382,339,464,417,,82,78
00025671_000.jpg,1024,1024,nodule,274,457,348,522,,74,65
00025695_007.jpg,1024,1024,nodule,534,569,651,675,,117,106
00025695_007.jpg,1024,1024,nodule,658,593,780,700,,122,107
00025695_007.jpg,1024,1024,nodule,539,257,623,330,,84,73
00025695_007.jpg,1024,1024,nodule,685,536,768,608,,83,72
00025695_024.jpg,1024,1024,nodule,274,361,351,434,,77,73
00025695_024.jpg,1024,1024,nodule,346,385,418,452,,72,67
00025695_025.jpg,1024,1024,nodule,342,301,409,371,,67,70
00025695_025.jpg,1024,1024,nodule,256,356,325,419,,69,63
00025695_025.jpg,1024,1024,nodule,319,379,388,446,,69,67
00025707_017.jpg,1024,1024,nodule,289,664,433,789,,144,125
00025707_017.jpg,1024,1024,nodule,179,284,227,340,,48,56
00025707_017.jpg,1024,1024,nodule,605,334,686,397,,81,63
00025707_017.jpg,1024,1024,nodule,695,359,766,427,,71,68
00025707_017.jpg,1024,1024,nodule,561,445,644,519,,83,74
00025707_017.jpg,1024,1024,nodule,574,529,670,604,,96,75
00025707_017.jpg,1024,1024,nodule,676,557,747,630,,71,73
00025707_017.jpg,1024,1024,nodule,151,599,221,671,,70,72
00025707_017.jpg,1024,1024,nodule,196,690,269,755,,73,65
00025714_000.jpg,1024,1024,nodule,848,432,902,477,,54,45
00025730_000.jpg,1024,1024,nodule,224,389,279,435,,55,46
00025812_006.jpg,1024,1024,nodule,132,167,257,275,,125,108
00025812_006.jpg,1024,1024,nodule,647,612,732,732,,85,120
00025812_006.jpg,1024,1024,nodule,128,289,174,343,,46,54
00025812_006.jpg,1024,1024,nodule,189,379,240,431,,51,52
00025812_006.jpg,1024,1024,nodule,153,430,209,481,,56,51
00025812_006.jpg,1024,1024,nodule,171,320,234,389,,63,69
00025812_006.jpg,1024,1024,nodule,102,366,165,440,,63,74
00025812_006.jpg,1024,1024,nodule,97,464,176,538,,79,74
00025812_006.jpg,1024,1024,nodule,647,503,719,590,,72,87
00025822_000.jpg,1024,1024,nodule,179,250,237,297,,58,47
00025936_001.jpg,1024,1024,nodule,671,194,754,272,,83,78
00025936_001.jpg,1024,1024,nodule,255,378,336,457,,81,79
00025936_001.jpg,1024,1024,nodule,672,412,745,483,,73,71
00025936_001.jpg,1024,1024,nodule,754,470,823,543,,69,73
00026004_002.jpg,1024,1024,nodule,675,261,711,298,,36,37
00026004_002.jpg,1024,1024,nodule,707,305,743,343,,36,38
00026004_002.jpg,1024,1024,nodule,645,376,694,429,,49,53
00026004_002.jpg,1024,1024,nodule,665,525,714,578,,49,53
00026004_002.jpg,1024,1024,nodule,804,528,854,577,,50,49
00026004_002.jpg,1024,1024,nodule,229,559,294,626,,65,67
00026004_002.jpg,1024,1024,nodule,705,569,753,619,,48,50
00026004_002.jpg,1024,1024,nodule,718,605,771,654,,53,49
00026004_002.jpg,1024,1024,nodule,789,659,837,710,,48,51
00026004_002.jpg,1024,1024,nodule,204,727,257,775,,53,48
00026004_002.jpg,1024,1024,nodule,818,742,870,791,,52,49
00026004_002.jpg,1024,1024,nodule,708,448,779,519,,71,71
00026004_002.jpg,1024,1024,nodule,650,564,718,634,,68,70
00026199_000.jpg,1024,1024,nodule,692,675,763,756,,71,81
00026223_000.jpg,1024,1024,nodule,646,194,756,314,,110,120
00026223_000.jpg,1024,1024,nodule,641,580,778,693,,137,113
00026223_000.jpg,1024,1024,nodule,612,547,687,632,,75,85
00026263_001.jpg,1024,1024,nodule,729,628,779,680,,50,52
00026330_001.jpg,1024,1024,nodule,162,638,283,741,,121,103
00026330_001.jpg,1024,1024,nodule,206,271,259,317,,53,46
00026330_001.jpg,1024,1024,nodule,166,353,218,403,,52,50
00026330_001.jpg,1024,1024,nodule,313,378,379,449,,66,71
00026330_001.jpg,1024,1024,nodule,283,592,354,669,,71,77
00026477_000.jpg,1024,1024,nodule,156,162,279,266,,123,104
00026477_000.jpg,1024,1024,nodule,699,351,803,458,,104,107
00026477_000.jpg,1024,1024,nodule,242,198,325,278,,83,80
00026477_000.jpg,1024,1024,nodule,646,182,719,252,,73,70
00026477_000.jpg,1024,1024,nodule,596,228,680,309,,84,81
00026477_000.jpg,1024,1024,nodule,723,264,810,334,,87,70
00026477_000.jpg,1024,1024,nodule,640,322,729,404,,89,82
00026477_000.jpg,1024,1024,nodule,310,344,387,406,,77,62
00026477_000.jpg,1024,1024,nodule,765,439,865,561,,100,122
00026477_000.jpg,1024,1024,nodule,704,532,786,610,,82,78
00026477_000.jpg,1024,1024,nodule,611,517,676,589,,65,72
00026477_000.jpg,1024,1024,nodule,203,293,265,357,,62,64
00026480_000.jpg,1024,1024,nodule,299,516,427,620,,128,104
00026545_000.jpg,1024,1024,nodule,189,365,270,433,,81,68
00026602_000.jpg,1024,1024,nodule,234,268,285,318,,51,50
00026606_000.jpg,1024,1024,nodule,782,680,833,730,,51,50
00026684_000.jpg,1024,1024,nodule,651,394,719,469,,68,75
00026684_001.jpg,1024,1024,nodule,740,418,798,464,,58,46
00026746_003.jpg,1024,1024,nodule,547,331,670,464,,123,133
00026746_003.jpg,1024,1024,nodule,768,684,841,761,,73,77
00026746_004.jpg,1024,1024,nodule,566,341,689,470,,123,129
00026746_004.jpg,1024,1024,nodule,620,630,725,738,,105,108
00026746_004.jpg,1024,1024,nodule,687,371,763,438,,76,67
00026746_004.jpg,1024,1024,nodule,794,683,868,753,,74,70
00026756_000.jpg,1024,1024,nodule,152,694,201,745,,49,51
00026769_007.jpg,1024,1024,nodule,120,635,269,791,,149,156
00026769_007.jpg,1024,1024,nodule,787,347,838,397,,51,50
00026769_010.jpg,1024,1024,nodule,790,415,841,466,,51,51
00026769_011.jpg,1024,1024,nodule,808,387,879,460,,71,73
00026791_001.jpg,1024,1024,nodule,305,258,343,294,,38,36
00026791_001.jpg,1024,1024,nodule,229,430,279,482,,50,52
00026791_001.jpg,1024,1024,nodule,195,430,266,499,,71,69
00026791_001.jpg,1024,1024,nodule,592,719,670,791,,78,72
00026843_000.jpg,1024,1024,nodule,737,385,861,481,,124,96
00026843_000.jpg,1024,1024,nodule,573,402,761,555,,188,153
00026843_000.jpg,1024,1024,nodule,178,537,337,652,,159,115
00026843_000.jpg,1024,1024,nodule,282,579,410,679,,128,100
00026843_000.jpg,1024,1024,nodule,220,246,277,299,,57,53
00026843_000.jpg,1024,1024,nodule,245,329,298,383,,53,54
00026843_000.jpg,1024,1024,nodule,176,450,228,500,,52,50
00026843_000.jpg,1024,1024,nodule,595,195,678,271,,83,76
00026843_000.jpg,1024,1024,nodule,747,224,822,291,,75,67
00026843_000.jpg,1024,1024,nodule,185,333,251,397,,66,64
00026843_000.jpg,1024,1024,nodule,363,312,435,381,,72,69
00026843_000.jpg,1024,1024,nodule,678,308,754,378,,76,70
00026843_000.jpg,1024,1024,nodule,279,362,358,427,,79,65
00026843_000.jpg,1024,1024,nodule,308,427,392,495,,84,68
00026843_000.jpg,1024,1024,nodule,166,484,229,560,,63,76
00026843_000.jpg,1024,1024,nodule,379,490,454,562,,75,72
00026843_000.jpg,1024,1024,nodule,761,488,838,547,,77,59
00026843_000.jpg,1024,1024,nodule,802,466,882,534,,80,68
00026843_000.jpg,1024,1024,nodule,777,552,877,621,,100,69
00026853_000.jpg,1024,1024,nodule,620,484,752,615,,132,131
00026853_000.jpg,1024,1024,nodule,828,588,918,660,,90,72
00026993_003.jpg,1024,1024,nodule,724,375,825,493,,101,118
00026993_003.jpg,1024,1024,nodule,733,481,850,612,,117,131
00026993_003.jpg,1024,1024,nodule,602,619,737,759,,135,140
00027019_000.jpg,1024,1024,nodule,587,807,661,881,,74,74
00027204_000.jpg,1024,1024,nodule,205,403,256,451,,51,48
00027204_000.jpg,1024,1024,nodule,242,570,299,615,,57,45
00027204_000.jpg,1024,1024,nodule,245,612,300,662,,55,50
00027204_000.jpg,1024,1024,nodule,731,625,780,675,,49,50
00027300_000.jpg,1024,1024,nodule,734,312,784,362,,50,50
00027300_000.jpg,1024,1024,nodule,707,348,757,402,,50,54
00027300_000.jpg,1024,1024,nodule,645,282,720,348,,75,66
00027300_000.jpg,1024,1024,nodule,265,391,336,467,,71,76
00027300_000.jpg,1024,1024,nodule,284,465,359,532,,75,67
00027300_000.jpg,1024,1024,nodule,364,707,442,783,,78,76
00027507_000.jpg,1024,1024,nodule,679,498,730,551,,51,53
00027507_000.jpg,1024,1024,nodule,728,595,802,666,,74,71
00027507_000.jpg,1024,1024,nodule,193,798,265,871,,72,73
00027564_001.jpg,1024,1024,nodule,677,404,785,520,,108,116
00027564_001.jpg,1024,1024,nodule,197,552,282,624,,85,72
00027564_001.jpg,1024,1024,nodule,632,554,722,624,,90,70
00027621_009.jpg,1024,1024,nodule,732,479,804,565,,72,86
00027897_000.jpg,1024,1024,nodule,674,372,788,473,,114,101
00027897_000.jpg,1024,1024,nodule,311,426,417,528,,106,102
00027927_009.jpg,1024,1024,nodule,742,390,797,438,,55,48
00027927_009.jpg,1024,1024,nodule,595,468,673,533,,78,65
00027929_000.jpg,1024,1024,nodule,275,316,326,365,,51,49
00028019_001.jpg,1024,1024,nodule,196,667,250,719,,54,52
00028219_000.jpg,1024,1024,nodule,735,390,839,491,,104,101
00028219_000.jpg,1024,1024,nodule,697,174,764,240,,67,66
00028219_000.jpg,1024,1024,nodule,749,269,827,342,,78,73
00028219_000.jpg,1024,1024,nodule,288,492,360,557,,72,65
00028219_000.jpg,1024,1024,nodule,815,485,895,559,,80,74
00028219_000.jpg,1024,1024,nodule,732,496,809,576,,77,80
00028219_000.jpg,1024,1024,nodule,240,563,317,636,,77,73
00028219_000.jpg,1024,1024,nodule,831,567,909,642,,78,75
00028219_000.jpg,1024,1024,nodule,616,594,683,664,,67,70
00028219_000.jpg,1024,1024,nodule,634,651,720,721,,86,70
00028219_000.jpg,1024,1024,nodule,276,280,355,345,,79,65
00028219_005.jpg,1024,1024,nodule,803,304,899,406,,96,102
00028219_005.jpg,1024,1024,nodule,210,349,322,456,,112,107
00028219_005.jpg,1024,1024,nodule,865,467,987,581,,122,114
00028219_005.jpg,1024,1024,nodule,777,479,898,608,,121,129
00028219_005.jpg,1024,1024,nodule,798,762,931,879,,133,117
00028219_005.jpg,1024,1024,nodule,744,208,820,279,,76,71
00028219_005.jpg,1024,1024,nodule,731,423,805,491,,74,68
00028219_005.jpg,1024,1024,nodule,701,603,783,681,,82,78
00028219_005.jpg,1024,1024,nodule,198,703,278,779,,80,76
00028219_005.jpg,1024,1024,nodule,634,734,704,810,,70,76
00028219_005.jpg,1024,1024,nodule,867,682,984,791,,117,109
00028265_006.jpg,1024,1024,nodule,753,602,853,724,,100,122
00028265_006.jpg,1024,1024,nodule,227,348,278,401,,51,53
00028359_002.jpg,1024,1024,nodule,695,338,833,457,,138,119
00028359_002.jpg,1024,1024,nodule,543,505,792,681,,249,176
00028359_002.jpg,1024,1024,nodule,247,552,335,616,,88,64
00028380_011.jpg,1024,1024,nodule,612,564,689,651,,77,87
00028380_011.jpg,1024,1024,nodule,277,584,370,655,,93,71
00028392_003.jpg,1024,1024,nodule,736,381,814,459,,78,78
00028518_026.jpg,1024,1024,nodule,687,348,822,500,,135,152
00028624_001.jpg,1024,1024,nodule,197,495,250,547,,53,52
00028624_001.jpg,1024,1024,nodule,265,494,340,563,,75,69
00028626_001.jpg,1024,1024,nodule,638,384,749,490,,111,106
00028626_001.jpg,1024,1024,nodule,225,209,281,258,,56,49
00028626_001.jpg,1024,1024,nodule,737,275,790,321,,53,46
00028626_001.jpg,1024,1024,nodule,319,321,373,369,,54,48
00028626_001.jpg,1024,1024,nodule,159,392,208,446,,49,54
00028626_001.jpg,1024,1024,nodule,172,444,224,495,,52,51
00028626_001.jpg,1024,1024,nodule,171,564,226,611,,55,47
00028626_001.jpg,1024,1024,nodule,847,596,907,641,,60,45
00028626_001.jpg,1024,1024,nodule,678,301,760,366,,82,65
00028626_001.jpg,1024,1024,nodule,199,420,272,492,,73,72
00028626_001.jpg,1024,1024,nodule,157,491,232,568,,75,77
00028626_001.jpg,1024,1024,nodule,224,515,297,586,,73,71
00028626_001.jpg,1024,1024,nodule,649,513,723,589,,74,76
00028626_001.jpg,1024,1024,Large_nodule,803,504,888,574,,85,70
00028626_001.jpg,1024,1024,Large_nodule,641,592,728,665,,87,73
00028626_001.jpg,1024,1024,Large_nodule,748,603,824,667,,76,64
00028626_001.jpg,1024,1024,Large_nodule,585,622,657,704,,72,82
00028626_001.jpg,1024,1024,Large_nodule,783,630,862,700,,79,70
00028796_000.jpg,1024,1024,Large_nodule,690,468,759,539,,69,71
00028796_000.jpg,1024,1024,Large_nodule,711,664,787,741,,76,77
00028796_000.jpg,1024,1024,Large_nodule,805,719,878,796,,73,77
00028876_021.jpg,1024,1024,Large_nodule,295,515,398,615,,103,100
00028876_021.jpg,1024,1024,Large_nodule,239,275,315,345,,76,70
00028876_022.jpg,1024,1024,Large_nodule,230,287,302,361,,72,74
00028876_022.jpg,1024,1024,Large_nodule,330,725,400,808,,70,83
00028876_032.jpg,1024,1024,Large_nodule,314,489,416,584,,102,95
00028876_032.jpg,1024,1024,,373,212,425,260,,52,48
00028876_032.jpg,1024,1024,Large_nodule,259,246,337,312,,78,66
00028876_032.jpg,1024,1024,Large_nodule,153,528,225,616,,72,88
00028876_035.jpg,1024,1024,Large_nodule,315,378,478,566,,163,188
00028876_035.jpg,1024,1024,,360,186,416,232,,56,46
00028876_035.jpg,1024,1024,,358,300,409,346,,51,46
00028876_035.jpg,1024,1024,,272,326,319,374,,47,48
00028876_035.jpg,1024,1024,Large_nodule,262,218,344,288,,82,70
00028876_035.jpg,1024,1024,Large_nodule,188,334,254,414,,66,80
00028876_035.jpg,1024,1024,Large_nodule,169,511,245,598,,76,87
00028876_035.jpg,1024,1024,Large_nodule,168,589,233,669,,65,80
00028876_035.jpg,1024,1024,Large_nodule,356,603,438,682,,82,79
00028876_061.jpg,1024,1024,Large_nodule,580,571,695,725,,115,154
00028876_061.jpg,1024,1024,,824,494,857,532,,33,38
00028876_061.jpg,1024,1024,,331,442,383,488,,52,46
00028876_061.jpg,1024,1024,,291,715,339,768,,48,53
00028876_061.jpg,1024,1024,Large_nodule,336,348,414,422,,78,74
00028876_061.jpg,1024,1024,Large_nodule,238,390,308,458,,70,68
00028876_061.jpg,1024,1024,Large_nodule,781,408,845,486,,64,78
00028876_061.jpg,1024,1024,Large_nodule,432,428,501,505,,69,77
00028876_061.jpg,1024,1024,Large_nodule,684,520,749,597,,65,77
00028876_061.jpg,1024,1024,Large_nodule,393,565,463,639,,70,74
00028876_061.jpg,1024,1024,Large_nodule,200,588,282,671,,82,83
00028876_061.jpg,1024,1024,Large_nodule,369,610,439,675,,70,65
00028876_061.jpg,1024,1024,Large_nodule,777,609,844,686,,67,77
00028923_002.jpg,1024,1024,Large_nodule,181,537,264,602,,83,65
00028963_002.jpg,1024,1024,Large_nodule,708,426,868,590,,160,164
00028963_002.jpg,1024,1024,Large_nodule,144,582,217,654,,73,72
00028963_002.jpg,1024,1024,Large_nodule,227,589,300,656,,73,67
00029150_001.jpg,1024,1024,Large_nodule,813,739,919,841,,106,102
00029159_003.jpg,1024,1024,Large_nodule,630,689,715,768,,85,79
00029450_001.jpg,1024,1024,Large_nodule,585,599,651,675,,66,76
00029450_001.jpg,1024,1024,Large_nodule,165,625,238,692,,73,67
00029475_000.jpg,1024,1024,Large_nodule,790,626,869,698,,79,72
00029579_009.jpg,1024,1024,Large_nodule,609,236,710,329,,101,93
00029579_009.jpg,1024,1024,Large_nodule,526,492,603,565,,77,73
00029579_009.jpg,1024,1024,Large_nodule,713,462,781,529,,68,67
00029617_001.jpg,1024,1024,,317,284,356,320,,39,36
00029617_001.jpg,1024,1024,,794,356,834,392,,40,36
00029617_001.jpg,1024,1024,,894,684,932,721,,38,37
00029617_001.jpg,1024,1024,,881,745,918,782,,37,37
00029617_001.jpg,1024,1024,,235,421,287,467,,52,46
00029617_001.jpg,1024,1024,,750,449,801,496,,51,47
00029617_001.jpg,1024,1024,,278,557,334,599,,56,42
00029617_001.jpg,1024,1024,,290,636,343,682,,53,46
00029617_001.jpg,1024,1024,,430,668,477,722,,47,54
00029617_001.jpg,1024,1024,,216,713,269,757,,53,44
00029617_001.jpg,1024,1024,Large_nodule,262,760,339,827,,77,67
00029617_001.jpg,1024,1024,Large_nodule,317,812,387,884,,70,72
00029649_000.jpg,1024,1024,Large_nodule,234,474,305,541,,71,67
00029678_001.jpg,1024,1024,Large_nodule,575,301,693,419,,118,118
00029678_001.jpg,1024,1024,,240,518,273,544,,33,26
00029748_000.jpg,1024,1024,,174,612,232,656,,58,44
00029756_001.jpg,1024,1024,,209,401,256,454,,47,53
00029756_001.jpg,1024,1024,Large_nodule,654,501,719,576,,65,75
00029756_001.jpg,1024,1024,Large_nodule,202,548,271,619,,69,71
00029756_001.jpg,1024,1024,Large_nodule,256,650,337,730,,81,80
00029756_001.jpg,1024,1024,Large_nodule,756,713,823,789,,67,76
00029756_001.jpg,1024,1024,,613,246,658,300,,45,54
00029757_000.jpg,1024,1024,Large_nodule,238,583,308,653,,70,70
00029809_000.jpg,1024,1024,,828,588,882,636,,54,48
00029809_000.jpg,1024,1024,,223,620,277,664,,54,44
00029820_003.jpg,1024,1024,,790,391,843,436,,53,45
00029820_003.jpg,1024,1024,,732,453,789,498,,57,45
00029820_003.jpg,1024,1024,Large_nodule,555,438,633,519,,78,81
00029820_003.jpg,1024,1024,Large_nodule,339,525,420,601,,81,76
00029844_003.jpg,1024,1024,Large_nodule,170,570,271,669,,101,99
00029844_003.jpg,1024,1024,,137,539,177,575,,40,36
00029844_003.jpg,1024,1024,,261,384,317,430,,56,46
00029844_003.jpg,1024,1024,,677,414,733,464,,56,50
00029844_003.jpg,1024,1024,,192,493,245,543,,53,50
00029844_003.jpg,1024,1024,,720,484,777,529,,57,45
00029844_003.jpg,1024,1024,,252,534,299,583,,47,49
00029844_003.jpg,1024,1024,,120,623,168,674,,48,51
00029844_003.jpg,1024,1024,,146,685,199,740,,53,55
00029844_003.jpg,1024,1024,,251,724,305,776,,54,52
00029844_003.jpg,1024,1024,Large_nodule,179,426,256,496,,77,70
00029844_003.jpg,1024,1024,Large_nodule,620,504,698,570,,78,66
00029844_003.jpg,1024,1024,Large_nodule,740,542,811,614,,71,72
00029844_003.jpg,1024,1024,Large_nodule,186,788,250,862,,64,74
00029861_000.jpg,1024,1024,,693,238,743,294,,50,56
00029861_000.jpg,1024,1024,,275,443,324,493,,49,50
00029861_000.jpg,1024,1024,,184,669,236,718,,52,49
00029861_000.jpg,1024,1024,Large_nodule,753,434,824,502,,71,68
00029861_000.jpg,1024,1024,Large_nodule,802,466,870,539,,68,73
00029861_000.jpg,1024,1024,Large_nodule,691,521,768,592,,77,71
00029866_005.jpg,1024,1024,Large_nodule,718,393,818,495,,100,102
00029909_004.jpg,1024,1024,,708,252,762,302,,54,50
00029909_004.jpg,1024,1024,,766,243,813,299,,47,56
00029909_004.jpg,1024,1024,,167,265,216,315,,49,50
00029909_004.jpg,1024,1024,,679,268,729,317,,50,49
00029909_004.jpg,1024,1024,,681,332,730,380,,49,48
00029909_004.jpg,1024,1024,,723,326,774,378,,51,52
00029909_004.jpg,1024,1024,,838,370,884,421,,46,51
00029909_004.jpg,1024,1024,,812,439,862,491,,50,52
00029909_004.jpg,1024,1024,,785,492,833,545,,48,53
00029909_004.jpg,1024,1024,,777,575,827,623,,50,48
00029909_004.jpg,1024,1024,,862,601,910,657,,48,56
00029909_004.jpg,1024,1024,,895,640,943,694,,48,54
00029909_004.jpg,1024,1024,Large_nodule,245,394,315,473,,70,79
00029909_004.jpg,1024,1024,Large_nodule,174,500,246,573,,72,73
00029909_004.jpg,1024,1024,Large_nodule,163,596,233,666,,70,70
00029909_004.jpg,1024,1024,Large_nodule,586,654,653,729,,67,75
00029909_004.jpg,1024,1024,Large_nodule,340,689,403,763,,63,74
00030162_029.jpg,1024,1024,Large_nodule,328,380,395,456,,67,76
00030162_029.jpg,1024,1024,Large_nodule,385,636,453,719,,68,83
00030280_003.jpg,1024,1024,,235,527,292,572,,57,45
00030536_004.jpg,1024,1024,,783,652,834,705,,51,53
00030536_006.jpg,1024,1024,,806,621,854,673,,48,52
00030541_000.jpg,1024,1024,,215,486,292,541,,77,55
00030541_000.jpg,1024,1024,Large_nodule,202,533,284,606,,82,73
